¶ Petit traicte tres	¶ Petit traicte tres
utile/ et salutaire de la	utile/ et salutaire de la
de nostre Sei¬	de nostre Sei¬
suchrist.	suchrist.
Audiens sapiens/	Audiens sapiens/
erit.	erit.
Aux beneuoles lecteurs: Salut.	Aux benevoles lecteurs: Salut.
Cest chose certaine et quasi a tous congneue/ que	C’est chose certaine et quasi a tous congneue/ que
me: iceluy est en grãd peril. Pour auquel mal/ incõ	me: iceluy est en grand peril. Pour auquel mal/ incon¬
ordonne toutes affectiõs ⁊ passiõs en cause de iuge-	ordonne toutes affections et passions en cause de juge-
mẽt/ estre reiectees ⁊ les occasiõs dicelles. De la uiẽt	ment/ estre rejectees et les occasions d’icelles. De la vient
ges/ quand il y a suspicion de faueur. Car ainsi que	ges/ quand il y a suspicion de faveur. Car ainsi que
miere du soleil: ainsi fõt les affectiõs ⁊ passiõs len¬	miere du soleil: ainsi font les affections et passions l’en¬
tiere congnoissance de uerite. Parquoy mes tres¬	tiere congnoissance de verite. Parquoy mes tres
uoꝰ supplie oster toute crainte humaine/ toute affe¬	vous supplie oster toute crainte humaine/ toute affe¬
restez a la cõsideration du long tẽps/ ne a la multi¬	restez a la consideration du long temps/ ne a la multi¬
tude de ceulx qͥ autremẽt ont tenu/ ⁊ dogmatise. Car	tude de ceulx qui autrement ont tenu/ et dogmatise. Car
titude ne soit oye cõtre uerite en iugement. Ne aussi	titude ne soit oye contre verite en jugement. Ne aussi
cõtre bonnes meurs/ elle est corruptelle. Par plus	contre bonnes meurs/ elle est corruptelle. Par plus
forte raison/ quãd elle est aduersaire a la saincte pa¬	forte raison/ quand elle est adversaire a la saincte pa¬
de tẽps enuieillie/ ou diminuee: mais eternellement	de temps envieillie/ ou diminuee: mais eternellement
faictes ie espere que entendrez clairement la pure/	faictes je espere que entendrez clairement la pure/
entiere/ et syncere uerite. Ce que le Seigneur uous	entiere/ et syncere verite. Ce que le Seigneur vous
T	T¬
nance de Dieu/ doibt	nance de Dieu/ doibt
estre dicte ⁊ tenue sain¬	estre dicte et tenue sain¬
quoy ce que Iesuchrist	quoy ce que Jesuchrist
⁊ diuin/ comme son sainct euãgile/	et divin/ comme son sainct evangile/
le sainct baptesme/ sa saincte cene et	le sainct baptesme/ sa saincte cene et
tain que Sathan soy transfigurant	tain que Sathan soy transfigurant
et iamais ne cesse de renuerser soubz	et jamais ne cesse de renverser soubz
quelque apparence de bien/ toute la	quelque apparence de bien/ toute la
ordõnances/ cõgnoissant que en icel¬	ordonnances/ congnoissant que en icel¬
lut de tout le monde consiste: car de	lut de tout le monde consiste: car de
Dieu et de sa uolunte ne pouuons	Dieu et de sa volunte ne pouvons
parolle. Parquoy il fault que tout ce	parolle. Parquoy il fault que tout ce
christ soit reigle/ conduict et monstre	christ soit reigle/ conduict et monstre
par icelle saincte parolle/ nõ pas par	par icelle saincte parolle/ non pas par
autrement il ny auroit iamais rien	autrement il n’y auroit jamais rien
lung diroit dune sorte/ puis lautre	l’ung diroit d’une sorte/ puis l’autre
dune autre. Ainsi que par longue et	d’une autre. Ainsi que par longue et
mal ⁊ dommage du paoure peuple	mal et dommage du paovre peuple
mal fault par layde et conduicte du	mal fault par l’ayde et conduicte du
Seigneur de paix et de uerite/ reti¬	Seigneur de paix et de verite/ reti¬
donnera de grace ⁊ pouuoir. A la¬	donnera de grace et pouvoir. A la¬
⁊ oblige par le uouloir ⁊ commãde¬	et oblige par le vouloir et commande¬
ment de Dieu trauailler ⁊ labourer.	ment de Dieu travailler et labourer.
exempt: mais plus tost sur peine de	exempt: mais plus tost sur peine de
cun doibt retirer derreur ⁊ mẽsonge	cun doibt retirer d’erreur et mensonge
son prochain/ autãt quil peult sans	son prochain/ autant qu’il peult sans
en Ezechiel: Si tu ne annonce a	en Ezechiel: Si tu ne annonce a
ie requerray son sang de ta main.	je requerray son sang de ta main.
Et pourtant le sainct homme Iob	Et pourtant le sainct homme Job
diligence instruisoit ⁊ enseignoit les	diligence instruisoit et enseignoit les
luy mesme tesmoigne/ disant: Ie ay	luy mesme tesmoigne/ disant: Je ay
este loeil a laueugle. A ceste cause	este l’oeil a l’aveugle. A ceste cause
grãdes tenebres qui sont/ ⁊ ia de lõg	grandes tenebres qui sont/ et ja de long
terre/ Iay este esmeu par bõne affe¬	terre/ J’ay este esmeu par bonne affe¬
ction de cõposer ⁊ rediger en escript	ction de composer et rediger en escript
portables abuz de la Messe. Lesq̃lz	portables abuz de la Messe. Lesquelz
chez par toꝰ les lieux publicq̃s de la	chez par tous les lieux publicques de la
terre: affin que icelle faulsete/ laq̃lle	terre: affin que icelle faulsete/ laquelle
chee/ soit dũg chascun entẽdue ⁊ am¬	chee/ soit d’ung chascun entendue et am¬
corde de Dieu on y puisse aduiser ⁊	corde de Dieu on y puisse adviser et
entierement remedier. Par cela desi¬	entierement remedier. Par cela desi¬
presence ie ne puis faire: car par tous	presence je ne puis faire: car par tous
pour la maintenãce ⁊ publicatiõ de	pour la maintenance et publication de
uerite iusque a la mort se exposer ⁊	verite jusque a la mort se exposer et
tendu auoir este mis et attachez en	tendu avoir este mis et attachez en
aduertissement a tout le monde/ de	advertissement a tout le monde/ de
auoir aduis a cela/ ⁊ tresfort le consi	avoir advis a cela/ et tres fort le consi¬
il a este tousiours experimente)	il a este tousjours experimente)
fice deuroiẽt inciter le paoure peuple	fice devroient inciter le paovre peuple
a tout bien ⁊ cõgnoissance de uerite/	a tout bien et congnoissance de verite/
empeschent/ procurans ⁊ esmouuãs	empeschent/ procurans et esmouvans
cutions/ noises/ et turbations/ pour	cutions/ noises/ et turbations/ pour
empescher ⁊ suffoquer tout cela qui	empescher et suffoquer tout cela qui
nes ⁊ Iambres resisterent a Moyse.	nes et Jambres resisterent a Moyse.
mes corrompuz dentendement/ re¬	mes corrompuz d’entendement/ re¬
prouuez enuers la foy. Lesquelz tou	prouvez envers la foy. Lesquelz tou¬
me dit le sainct Apostre/ leur insipiẽ¬	me dit le sainct Apostre/ leur insipien¬
il dict insipience. Car ueritablement	il dict insipience. Car veritablement
leur ignorãce est si merueilleuse/ que	leur ignorance est si merveilleuse/ que
aueugles/ et (cõme dict Iesuchrist)	aveugles/ et (comme dict Jesuchrist)
les gẽs Isaye parle en ceste maniere.	les gens Isaye parle en ceste maniere.
Les cõducteurs du peuple sont tous	Les conducteurs du peuple sont tous
Auquel passage il est bien euidẽt	Auquel passage il est bien evident
des moindres: mais de ceulx qui sõt	des moindres: mais de ceulx qui sont
constituez en dignite/ et estimez du	constituez en dignite/ et estimez du
la clef de science ⁊ ny entrent point/	la clef de science et n’y entrent point/
ceulx qui desyrent y entrer.	ceulx qui desyrent y entrer.
De cecy nous auons maintenant	De cecy nous avons maintenant
de Paris: lesquelz ont deffendu que	de Paris: lesquelz ont deffendu que
leurs actes le Grec ou Ebrieu/ sur	leurs actes le Grec ou Ebrieu/ sur
grosse peine par eulx ordonnee. En	grosse peine par eulx ordonnee. En
mys de toutes bonnes lettres: ainsi	mys de toutes bonnes lettres: ainsi
ilz desirent ⁊ ueullent estre ueuz les	ilz desirent et veullent estre veuz les
plus grans ⁊ plus scauans. Comme	plus grans et plus scavans. Comme
ignorante barbarie: mesme en leurs	ignorante barbarie: mesme en leurs
appostez pour frapper ⁊ faire bruict	appostez pour frapper et faire bruict
se il aduient que le arguant suyue ⁊	se il advient que le arguant suyve et
de irrision ⁊ pure mocquerie.	de irrision et pure mocquerie.
uãt/ insiste fort a la saĩcte escripture/	vant/ insiste fort a la saincte escripture/
ainsi que ung chascun deuroit faire/	ainsi que ung chascun devroit faire/
sonne: a tout le moins a force de	sonne: a tout le moins a force de
ilz: affin que uerite ne soit clairemẽt	ilz: affin que verite ne soit clairement
entendue des assistans: car autre rai	entendue des assistans: car autre rai¬
Dauãtage ie leur demanderoye	Davantage je leur demanderoye
⁊ disputations publicq̃s par cy auãt	et disputations publicques par cy avant
faictes/ quantes bõnes ⁊ chrestiẽnes	faictes/ quantes bonnes et chrestiennes
mais/ toutesfoys ilz auoiẽt este pre¬	mais/ toutesfoys ilz avoient este pre¬
Roys/ pour simplement ⁊ purement	Roys/ pour simplement et purement
declairer la saincte parolle de Dieu/	declairer la saincte parolle de Dieu/
leͬs songes/ apres Aristote/ ⁊ autres	leurs songes/ apres Aristote/ et autres
abandõnans Iesuchrist. Parquoy	abandonnans Jesuchrist. Parquoy
deuroient estre totallement deiectez/	devroient estre totallement dejectez/
deuoir ⁊ office.	devoir et office.
ple: nest ce pas trop empesche/ ⁊ reti¬	ple: n’est ce pas trop empesche/ et reti¬
re les paoures ames rachaptees du	re les paovres ames rachaptees du
gnoissance de la pure ⁊ saincte uerite	gnoissance de la pure et saincte verite
il est prohibe ⁊ deffendu/ de ne auoir	il est prohibe et deffendu/ de ne avoir
aucũs liures en langaige uulgaire/	aucuns livres en langaige vulgaire/
est cõcede en auoir: mais quilz soyẽt	est concede en avoir: mais qu’ilz soyent
songes: et bien souuent dinfection et	songes: et bien souvent d’infection et
paillardise.	paillardise.
table et dur iugement sera faict sur	table et dur jugement sera faict sur
si ung Roy mortel ueult estre obey/	si ung Roy mortel veult estre obey/
que dira on du Roy Eternel? Et ie	que dira on du Roy Eternel? Et je
cõmande aucune chose pour estre pu	commande aucune chose pour estre pu¬
superbe/ ou presumptueux temerai¬	superbe/ ou presumptueux temerai¬
re/ le tout rẽuerser: et faire que iceluy	re/ le tout renverser: et faire que iceluy
du peuple. Ascauoir si le prince en se¬	du peuple. A scavoir si le prince en se¬
nition? Ueritablemẽt si feroit/ et fi¬	nition? Veritablement si feroit/ et fi¬
nablement seroit amplement mani¬	nablement seroit amplement mani¬
ou non les rebelles fauldra il que la	ou non les rebelles fauldra il que la
beau contredire/ on a beau tuer/ em¬	beau contredire/ on a beau tuer/ em¬
pescher/ meurtrir/ ⁊ brusler. Le con¬	pescher/ meurtrir/ et brusler. Le con¬
esleu les choses basses et infirmes/	esleu les choses basses et infirmes/
fortes: affin que toute gloire soit a	fortes: affin que toute gloire soit a
luy seul/ ⁊ q̃ nulle chair ne se uienne	luy seul/ et que nulle chair ne se vienne
A ceste cause: en la confidence du	A ceste cause: en la confidence du
aucuns pointz de la saincte Eucha¬	aucuns pointz de la saincte Eucha¬
ristie/ ⁊ cela faire en langaige mater¬	ristie/ et cela faire en langaige mater¬
ligence des moindres. Le tout sub¬	ligence des moindres. Le tout sub¬
ment de la saincte parolle de Dieu/	ment de la saincte parolle de Dieu/
par laquelle il fault que telle matie¬	par laquelle il fault que telle matie¬
nõ pas par la uolunte ou raison hu¬	non pas par la volunte ou raison hu¬
dhõmes: autremẽt ce ne seroit point	d’hommes: autrement ce ne seroit point
chose qui fust purement de Dieu/ le¬	chose qui fust purement de Dieu/ le¬
tost seroit de lhomme/ qui de soy nest	tost seroit de l’homme/ qui de soy n’est
D	D¬
Onc pour le p̃mier poĩt	Onc pour le premier point
ceste matiere/ on a trop	ceste matiere/ on a trop
a tout fidele chrestien/ il est necessaire	a tout fidele chrestien/ il est necessaire
de congnoistre ⁊ scauoir: mettãt cela	de congnoistre et scavoir: mettant cela
Seigneur ⁊ seul sauueur Iesuchrist/	Seigneur et seul sauveur Jesuchrist/
nellement ordonne de Dieu: non se¬	nellement ordonne de Dieu: non se¬
lon lordre de Aharon: mais selon lor	lon l’ordre de Aharon: mais selon l’or¬
grand/ et plus parfaict que Moyse q̃	grand/ et plus parfaict que Moyse que
nom de seruiteur/ a offert ⁊ donne en	nom de serviteur/ a offert et donne en
sacrifice tresparfaict soy mesme/ cest	sacrifice tres parfaict soy mesme/ c’est
pour nostre salut ⁊ redemption. Par	pour nostre salut et redemption. Par
admirable/ ⁊ misericordieux sacrifi¬	admirable/ et misericordieux sacrifi¬
ce/ il a euacue tout autre sacrifice ui¬	ce/ il a evacue tout autre sacrifice vi¬
sacrificateurs/ des Leuites/ et ceulx	sacrificateurs/ des Levites/ et ceulx
temple materiel/ a este par cestuy cy	temple materiel/ a este par cestuy cy
du tout aboly et destruict/ sans que	du tout aboly et destruict/ sans que
uisible soit demoure: cõme cy apres	visible soit demoure: comme cy apres
desquelles choses par sa sapience et	desquelles choses par sa sapience et
bonte/ a ordonne sa saincte table/ sa	bonte/ a ordonne sa saincte table/ sa
est le pain de actiõ de graces/ en me¬	est le pain de action de graces/ en me¬
ble ⁊ inestimable charite/ par laquel¬	ble et inestimable charite/ par laquel¬
le il sest baille uoluntairement a la	le il s’est baille voluntairement a la
ty/ ⁊ remply dopprobre ⁊ confusion/	ty/ et remply d’opprobre et confusion/
tion/ nous admõnestant que de cela	tion/ nous admonnestant que de cela
eussions tousiours memoire/ aymãs	eussions tousjours memoire/ aymans
Et toutesfoys par grosse inaduer	Et toutesfoys par grosse inadver¬
dauoir tresbien regarde ainsi que il	d’avoir tres bien regarde ainsi que il
appartiẽt aux sainctes escriptures/	appartient aux sainctes escriptures/
sion/ on a de icelle saĩcte eucharistie/	sion/ on a de icelle saincte eucharistie/
donnãce de Iesuchrist/ afferme/ don	donnance de Jesuchrist/ afferme/ don¬
ne entendre ⁊ enseigne que cest ung	ne entendre et enseigne que c’est ung
a Dieu/ comme celuy de Abraham/	a Dieu/ comme celuy de Abraham/
tant pour les uiuans que pour les	tant pour les vivans que pour les
trespassez/ qui nest autre chose/ sinon	trespassez/ qui n’est autre chose/ sinon
christ estre inefficax/ insuffisant/ et	christ estre inefficax/ insuffisant/ et
lemẽt dire/ mais aussi penser est une	lement dire/ mais aussi penser est une
horrible ingratitude/ ung terrible ⁊	horrible ingratitude/ ung terrible et
il appert: Car ie demande si le sa¬	il appert: Car je demande si le sa¬
parfaict/ pour le salut des eufans de	parfaict/ pour le salut des enfans de
Dieu. Sil est du tout parfaict/ il ne	Dieu. S’il est du tout parfaict/ il ne
auec Iesuchrist/ pour estre ses com¬	avec Jesuchrist/ pour estre ses com¬
parfaict/ q̃lle chose plus oultrageuse	parfaict/ quelle chose plus oultrageuse
pourroit on dire contre iceluy nostre	pourroit on dire contre iceluy nostre
grand mesprisement dung si grand	grand mesprisement d’ung si grand
renõcement dicelle tant saincte mort	renoncement d’icelle tant saincte mort
⁊ angoisseuse passion: Ce que par la	et angoisseuse passion: Ce que par la
Au septiesme chapitre de lepistre	Au septiesme chapitre de l’epistre
christ entre autres choses il est ainsi	christ entre autres choses il est ainsi
escript: Il estoit conuenable que	escript: Il estoit convenable que
innocent/ sans macule/ separe des pe	innocent/ sans macule/ separe des pe¬
Lequel na point necessite (cõme les	Lequel n’a point necessite (comme les
prebstres) offrir tous les iours sa¬	prebstres) offrir tous les jours sa¬
puis apres pour ceulx du peuple.	puis apres pour ceulx du peuple.
Notamment le sainct apostre dict/ en	Notamment le sainct apostre dict/ en
se offrant une fois: car iamais telle	se offrant une fois: car jamais telle
mais comme plainemẽt suffisante et	mais comme plainement suffisante et
fy ⁊ satisfaict pour une fois.	fy et satisfaict pour une fois.
Au neufiesme chapitre dicelle mes	Au neufiesme chapitre d’icelle mes¬
euesque des biens aduenir/ est uenu	evesque des biens advenir/ est venu
plus parfaict tabernacle/ non point	plus parfaict tabernacle/ non point
faict de la main: cest adire/ nõ point	faict de la main: c’est a dire/ non point
de boucz ou de ueaulx: mais par son	de boucz ou de veaulx: mais par son
ctuaires/ ⁊ a trouue redemptiõ eter¬	ctuaires/ et a trouve redemption eter¬
nelle.	nelle.
se estre presente une fois/ Redẽption	se estre presente une fois/ Redemption
quoy il est bien euident q̃ pour nostre	quoy il est bien evident que pour nostre
redemption/ ne auons point besoing	redemption/ ne avons point besoing
crifians pour nous iournellement/	crifians pour nous journellement/
si nous ne uoulons renõcer a lobla¬	si nous ne voulons renoncer a l’obla¬
tion de Iesuchrist: ou reputer icelle	tion de Jesuchrist: ou reputer icelle
feste par le texte diceluy mesme cha¬	feste par le texte d’iceluy mesme cha¬
Iesus nest point entre aux sãctuai¬	Jesus n’est point entre aux sanctuai¬
res faictz des mains/ figures des	res faictz des mains/ figures des
maintenãt il apparoisse pour nous	maintenant il apparoisse pour nous
affin quil se offre souuentesfois/ au¬	affin qu’il se offre souventes fois/ au¬
trement (dict il par apres) il luy eut	trement (dict il par apres) il luy eut
le commencement du monde. Mais	le commencement du monde. Mais
siecles: cest adire au dernier temps/	siecles: c’est a dire au dernier temps/
il est apparu une foys par son sacri¬	il est apparu une foys par son sacri¬
ainsi quil est ordonne aux hommes	ainsi qu’il est ordonne aux hommes
gemẽt: ainsi aussi Christ a este offert	gement: ainsi aussi Christ a este offert
une foys/ pour abolir les pechez de	une foys/ pour abolir les pechez de
Uoicy certes ung texte fort ex¬	Voicy certes ung texte fort ex¬
christ ne se offre point souuẽtesfois/	christ ne se offre point souventes fois/
autrement luy fauldroit mourir plu	autrement luy fauldroit mourir plu¬
estre offert a son pere/ cest tout ung.	estre offert a son pere/ c’est tout ung.
iamais ne sera sacrifie/ ⁊ iamais en	jamais ne sera sacrifie/ et jamais en
sacrifice ne se offrira. Dõc il sensuyt	sacrifice ne se offrira. Donc il s’ensuyt
poĩt offrir ⁊ sacrifier: Car si luy mes¬	point offrir et sacrifier: Car si luy mes¬
offrir? Sur quoy il cõuient expresse¬	offrir? Sur quoy il convient expresse¬
ment noter que toute chose sacrifiee	ment noter que toute chose sacrifiee
ou equale au sacrificateur. Ie dis	ou equale au sacrificateur. Je dis
iamais furent offers en la loy/ cõe il	jamais furent offers en la loy/ come il
appert de ueaulx/ daigneaulx/ doy¬	appert de veaulx/ d’aigneaulx/ d’oy¬
lesquelles du tout estoiẽt inferieures	lesquelles du tout estoient inferieures
il fut cõmande a Abraham quil sa¬	il fut commande a Abraham qu’il sa¬
crifiast son filz Isaac au Seigneur:	crifiast son filz Isaac au Seigneur:
equale poͬ le sacrifice de Iesuchrist/	equale pour le sacrifice de Jesuchrist/
son pere: a cause quil ny auoit crea¬	son pere: a cause qu’il n’y avoit crea¬
ture ne au ciel ne en la terre/ a iceluy	ture ne au ciel ne en la terre/ a iceluy
tel sacrifice. Parquoy il a conuenu	tel sacrifice. Parquoy il a convenu
crifie/ par lordonnance de son pere:	crifie/ par l’ordonnance de son pere:
comme luy mesme a dict/ Sicut man¬	comme luy mesme a dict/ Sicut man¬
dire/ ainsi que mon pere ma donne le	dire/ ainsi que mon pere m’a donne le
tenant ie demãde a tout hõme qui se	tenant je demande a tout homme qui se
dict sacrificateur/ ⁊ qui uient affer¬	dict sacrificateur/ et qui vient affer¬
a Dieu son pere: sil est equal/ infe¬	a Dieu son pere: s’il est equal/ infe¬
De se dire superieur ou equal/ il ne	De se dire superieur ou equal/ il ne
oseroit: Reste dõc qͥl soit inferieur.	oseroit: Reste donc qu’il soit inferieur.
ne le peult par sacrifice presenter. Et	ne le peult par sacrifice presenter. Et
crifice: ou il fault conceder que Iesu¬	crifice: ou il fault conceder que Jesu¬
christ ny est point/ qͥ est matiere pour	christ n’y est point/ qui est matiere pour
chose quil responde tousiours par sa	chose qu’il responde tousjours par sa
cu: car il fault cõbien quil tarde/ que	cu: car il fault combien qu’il tarde/ que
faulsete se destruise soy mesme/ ou q̃	faulsete se destruise soy mesme/ ou que
Et ne fault point dire que le sacri	Et ne fault point dire que le sacri¬
memoire de ce premier sacrifice: car	memoire de ce premier sacrifice: car
memoire de sacrifice nest point sacri¬	memoire de sacrifice n’est point sacri¬
que tous noz sacrificateurs qui font	que tous noz sacrificateurs qui font
⁊ font sacrifice pour les uifz ⁊ pour	et font sacrifice pour les vifz et pour
les mortz/ uoire ⁊ encore (qͥ plus est)	les mortz/ voire et encore (qui plus est)
plaist choisir ⁊ nõmer. En quoy trop	plaist choisir et nommer. En quoy trop
sont abusez/ ou abuseurs. Car pour	sont abusez/ ou abuseurs. Car pour
certain depuis la mort de Iesuchrist	certain depuis la mort de Jesuchrist
des sacrificateurs est expire.	des sacrificateurs est expire.
il fault considerer le .x. chap̃. dicelle	il fault considerer le .x. chapitre d’icelle
mesme epistre/ la ou quasi par tout	mesme epistre/ la ou quasi par tout
de Iesuchrist/ Leq̃l a mis fin a tous	de Jesuchrist/ Lequel a mis fin a tous
uisible soit demoure. Et entre au¬	visible soit demoure. Et entre au¬
tres choses il est ainsi dict en la per¬	tres choses il est ainsi dict en la per¬
affin sire dieu que ie face ta uolunte.	affin sire dieu que je face ta volunte.
nous sõmes sanctifiez par loblation	nous sommes sanctifiez par l’oblation
une foys faicte du corps de Christ.	une foys faicte du corps de Christ.
tion il a parfaict eternellement les	tion il a parfaict eternellement les
testifie: car apres il dict/ Ie nauray	testifie: car apres il dict/ Je n’auray
plus souuenãce de leurs pechez/ ⁊ de	plus souvenance de leurs pechez/ et de
sion dicelles/ il ny a plus doblation	sion d’icelles/ il n’y a plus d’oblation
Et affin que excuse de ignorance	Et affin que excuse de ignorance
ne soit en nous/ considerons que ces	ne soit en nous/ considerons que ces
ont dict/ que bien uray est Iesuchrist	ont dict/ que bien vray est Jesuchrist
principallemẽt pour le peche de Adã	principallement pour le peche de Adam
⁊ (ainsi quilz parlent) pour le peche	et (ainsi qu’ilz parlent) pour le peche
les pechez que actuellement nous cõ	les pechez que actuellement nous com¬
tre chose/ sinõ dire ⁊ blasphemer/ que	tre chose/ sinon dire et blasphemer/ que
nostre seigneur Iesuchrist na point	nostre seigneur Jesuchrist n’a point
demption. Et pourtant ainsi quilz	demption. Et pourtant ainsi qu’ilz
Iesuchrist pour luy ayder a faire nr̃e	Jesuchrist pour luy ayder a faire notre
redemption/ ⁊ que ilz fussent noz re¬	redemption/ et que ilz fussent noz re¬
Messe sacrifice pour la remission de	Messe sacrifice pour la remission de
audace/ ⁊ trop malheureuse arrogã¬	audace/ et trop malheureuse arrogan¬
ce. Poͬ laquelle assommer ⁊ abbatre	ce. Pour laquelle assommer et abbatre
est dict en ceste maniere: Si nous pe	est dict en ceste maniere: Si nous pe¬
receu congnoissance de uerite/ il ne	receu congnoissance de verite/ il ne
nous est plus laisse sacrifice pour les	nous est plus laisse sacrifice pour les
Lesquelles parolles sont si claires	Lesquelles parolles sont si claires
pourroit assez esmerueiller comment	pourroit assez esmerveiller comment
le monde a este si aueugle ⁊ deceu/ de	le monde a este si aveugle et deceu/ de
crifier ⁊ presenter aucun sacrifice ui¬	crifier et presenter aucun sacrifice vi¬
pour noz pechez: attendu que si con¬	pour noz pechez: attendu que si con¬
stammẽt/ si puissammẽt/ tãt de foys	stamment/ si puissamment/ tant de foys
ferme et dict: que il ny a plus aucun	ferme et dict: que il n’y a plus aucun
Iesuchrist ne fault attendre aucun	Jesuchrist ne fault attendre aucun
autre sacrificateur: mais il a faillu ⁊	autre sacrificateur: mais il a faillu et
luy ⁊ ses ministres ayt seduict le mõ¬	luy et ses ministres ayt seduict le mon¬
predict et prophetize/ que tout deuoit	predict et prophetize/ que tout devoit
estre ainsi perdu ⁊ gaste. Et tout poͬ	estre ainsi perdu et gaste. Et tout pour
gloire/ ⁊ magnificence du souuerain	gloire/ et magnificence du souverain
parolle/ par lesperit de sa bouche (il	parolle/ par l’esperit de sa bouche (il
ne dict poĩt par miracles/ ou par for¬	ne dict point par miracles/ ou par for¬
nera ⁊ abbatra le regne de ses enne¬	nera et abbatra le regne de ses enne¬
monde/ denfer/ ⁊ de Satan.	monde/ d’enfer/ et de Satan.
Las ne a ce pas este grosse misere	Las ne a ce pas este grosse misere
prealleguez/ de les auoir ainsi cõtem	prealleguez/ de les avoir ainsi contem¬
ment y auoir aduise? sans iamais	ment y avoir advise? sans jamais
auoir uoulu cõsiderer/ q̃ il y a grãde	avoir voulu considerer/ que il y a grande
Car quand nous offrons sacrifice a	Car quand nous offrons sacrifice a
Par quoy tl est bien euidẽt/ que quãd	Par quoy il est bien evident/ que quand
nous prenons ⁊ receuõs de luy aucu	nous prenons et recevons de luy aucu¬
mais liberalle donation et pure mi¬	mais liberalle donation et pure mi¬
Et qui peult estre donc si aueugle	Et qui peult estre donc si aveugle
qui ne uoit icy clairement que par	qui ne voit icy clairement que par
la mort du testateur/ ꝑ grãd amour	la mort du testateur/ par grand amour
Saĩct Luc le touche au uif/ quãd il	Sainct Luc le touche au vif/ quand il
escript en ceste maniere: Ce calice/ est	escript en ceste maniere: Ce calice/ est
qui sera espandu pour uous. A ceste	qui sera espandu pour vous. A ceste
oubliãce (affin que ne dye ingratitu	oubliance (affin que ne dye ingratitu¬
de) une telle donation/ qui est grace	de) une telle donation/ qui est grace
ger en sacrifice.	ger en sacrifice.
sons ce que dict S. Paul/ ⁊ croyons	sons ce que dict Sainct Paul/ et croyons
a son diuin conseil/ quand il dict:	a son divin conseil/ quand il dict:
misericorde de Dieu/ q̃ uous offrez	misericorde de Dieu/ que vous offrez
plaisãt a Dieu ⁊c. A tel sacrifice noꝰ	plaisant a Dieu etc. A tel sacrifice nous
sommes tous ordonnez de Dieu/	sommes tous ordonnez de Dieu/
rechef luy offrir son filz en sacrifice.	rechef luy offrir son filz en sacrifice.
sõmes trop indignes/ cõme dict est:	sommes trop indignes/ comme dict est:
Parquoy luy mesme sest offert pour	Parquoy luy mesme s’est offert pour
quelle oblation pour tout temps est	quelle oblation pour tout temps est
il la fauldroit reiterer ⁊ ꝑfaire/ pour	il la fauldroit reiterer et parfaire/ pour
tant quelle seroit imparfaicte: ou cer	tant quelle seroit imparfaicte: ou cer¬
Ce que par efficax argumẽt de lescri	Ce que par efficax argument de l’escri¬
En lepistre aux Ebrieux par plu	En l’epistre aux Ebrieux par plu¬
sieurs argumens il est conclud/ que	sieurs argumens il est conclud/ que
failloit ordonner ung autre. Et par	failloit ordonner ung autre. Et par
tre/ ⁊ ainsi consequãment iusque a	tre/ et ainsi consequamment jusque a
ce quil en soit uenu ung totallemẽt	ce qu’il en soit venu ung totallement
teur Iesuchrist/ lequel tousiours as¬	teur Jesuchrist/ lequel tousjours as¬
Semblablemẽt pour limꝑfection	Semblablement pour l’imperfection
des sacrifices de lanciẽne loy/ failloit	des sacrifices de l’ancienne loy/ failloit
ce quil en ayt este offert ung/ du tout	ce qu’il en ayt este offert ung/ du tout
reiterer. Lequel tressainct ⁊ trespar¬	reiterer. Lequel tres sainct et tres par¬
faict sacrifice/ a este faict par nostre	faict sacrifice/ a este faict par nostre
qui se est offert soymesme en sacrifice	qui se est offert soy mesme en sacrifice
meilleure ou aussi bonne ne eust sceu	meilleure ou aussi bonne ne eust sceu
trouuer apres Dieu. Tout cecy est	trouver apres Dieu. Tout cecy est
x. chap̃. dicelle epistre.	x. chapitre d’icelle epistre.
tous sacrificateͬs si leur sacrifice est	tous sacrificateurs si leur sacrifice est
parfaict ou imparfaict. Se il est im¬	parfaict ou imparfaict. Se il est im¬
le paoure mõde en uendãt une chose	le paovre monde en vendant une chose
a quoy le fault il ainsi iournellemẽt	a quoy le fault il ainsi journellement
reiterer/ ⁊ tant souuẽt a millions re¬	reiterer/ et tant souvent a millions re¬
Mettez uous en auãt paoures sa	Mettez vous en avant paovres sa¬
de respondre/ respondez. Car uolun¬	de respondre/ respondez. Car volun¬
tiers ie orray sur cecy uostre respõse/	tiers je orray sur cecy vostre response/
produirez.	produirez.
tãt appertes ⁊ manifestes/ que tout	tant appertes et manifestes/ que tout
homme doibt auoir honte dy contre¬	homme doibt avoir honte d’y contre¬
leur cas/ maintenant disent que pro¬	leur cas/ maintenant disent que pro¬
fie: mais seullement ont offert sacri¬	fie: mais seullement ont offert sacri¬
fice de louenge: qui est appertement	fice de louenge: qui est appertement
lequel ilz nõment ⁊ appellẽt ce pain	lequel ilz nomment et appellent ce pain
que ilz disent sacramentales) sainct	que ilz disent sacramentales) sainct
sacrifice/ saincte oblation presentee ⁊	sacrifice/ saincte oblation presentee et
Abel ⁊ Abraham. Et cõmunement	Abel et Abraham. Et communement
sacrifice ⁊ telles manieres de noms.	sacrifice et telles manieres de noms.
sacrifice de louenge/ il ne fault ne	sacrifice de louenge/ il ne fault ne
pain ne uin/ il ne fault lumiere ne	pain ne vin/ il ne fault lumiere ne
ne rase/ ne estre desguise par acoustre	ne rase/ ne estre desguise par acoustre¬
mens nouueaulx ⁊ inacoustumez.	mens nouveaulx et inacoustumez.
leurs abuz par telles fictiõs/ par les¬	leurs abuz par telles fictions/ par les¬
destruysent/ ne ayans point tant de	destruysent/ ne ayans point tant de
sens de entẽdre que en parlant ainsi/	sens de entendre que en parlant ainsi/
dent. Car sacrifice de louẽge est ne¬	dent. Car sacrifice de louenge est ne¬
soient hommes ou femmes ⁊ petitz	soient hommes ou femmes et petitz
enfans: ⁊ toute personne est obligee	enfans: et toute personne est obligee
Et par ainsi/ si en leur cas nya au¬	Et par ainsi/ si en leur cas n’y a au¬
une femme pourroit bien sacrifier/	une femme pourroit bien sacrifier/
uoire mesme ung petit enfant: qui	voire mesme ung petit enfant: qui
acoustumee doctrine: ainsi que eulx	acoustumee doctrine: ainsi que eulx
Or ont ilz dict le tẽps passe par	Or ont ilz dict le temps passe par
toutes uniuersitez/ que la Messe di¬	toutes universitez/ que la Messe di¬
estoit/ et est aussi bonne/ comme la	estoit/ et est aussi bonne/ comme la
Laquelle chose nous leur cõfessons	Laquelle chose nous leur confessons
estre plus ueritable quilz ne pensent.	estre plus veritable qu’ilz ne pensent.
Toutesfoys leur intention est dire	Toutesfoys leur intention est dire
de celuy qui faict telle oeuure: mais	de celuy qui faict telle oeuvre: mais
par la uertu de la chose oeuuree/ cest	par la vertu de la chose oeuvree/ c’est
sentee. Et en leur latin disẽt: Non uir	sentee. Et en leur latin disent: Non vir¬
rati. Qui est toute follie songee ⁊ in¬	rati. Qui est toute follie songee et in¬
uentee par inuention humaine/ ainsi	ventee par invention humaine/ ainsi
Parquoy au secõd point de la pre	Parquoy au second point de la pre¬
presence corporelle de Iesuchrist/ en	presence corporelle de Jesuchrist/ en
la saincte eucharistie fault mainte¬	la saincte eucharistie fault mainte¬
E	E¬
on a failly ⁊ grandemẽt er	on a failly et grandement er¬
re/ quand on a presche/ dõ¬	re/ quand on a presche/ don¬
au lieu du pain ⁊ du uin (ainsi quilz	au lieu du pain et du vin (ainsi qu’ilz
le corps de Iesuchrist/ realement ⁊ de	le corps de Jesuchrist/ realement et de
faict/ entierement ⁊ personnellement	faict/ entierement et personnellement
faict/ comme de present il est uiuant/	faict/ comme de present il est vivant/
ainsi on a prouocque quasi luniuer¬	ainsi on a provocque quasi l’univer¬
sel mõde a idolatrie publicque ⁊ ma	sel monde a idolatrie publicque et ma¬
sainctes escriptures cõuiẽt puissam¬	sainctes escriptures convient puissam¬
Tout premierement nous fault	Tout premierement nous fault
biẽ retenir ⁊ noter/ que Iesuchrist est	bien retenir et noter/ que Jesuchrist est
nostre iustification. Et apres sa re¬	nostre justification. Et apres sa re¬
a la dextre de sõ pere/ regnãt en plai	a la dextre de son pere/ regnant en plai¬
ne maieste: auquel toute puissãce est	ne majeste: auquel toute puissance est
Que il soit monte au ciel uisible¬	Que il soit monte au ciel visible¬
disciples: il est certain a tout fidele	disciples: il est certain a tout fidele
chrestien. De laquelle tant admi¬	chrestien. De laquelle tant admi¬
et ueritables tesmoings: comme il	et veritables tesmoings: comme il
par sainct Marc au dernier chapitre	par sainct Marc au dernier chapitre
de son euangile.	de son evangile.
Colossiens dict en ceste maniere: Si	Colossiens dict en ceste maniere: Si
chez les choses qui sont denhault/ ou	chez les choses qui sont d’en hault/ ou
Christ est seand a la dextre de Dieu.	Christ est seand a la dextre de Dieu.
en la mer/ ou en la terre: mais au ciel.	en la mer/ ou en la terre: mais au ciel.
au ciel assis a la dextre de Dieu/ que	au ciel assis a la dextre de Dieu/ que
il nest pas ca bas en la terre/ entre	il n’est pas ca bas en la terre/ entre
boyste/ ou armaire. Car son corps ne	boyste/ ou armaire. Car son corps ne
une foys.	une foys.
Parquoy si son corps est au ciel/	Parquoy si son corps est au ciel/
la terre: ⁊ sil estoit en la terre/ il ne se	la terre: et s’il estoit en la terre/ il ne se¬
iamais ung ueritable corps nest que	jamais ung veritable corps n’est que
en ung seul lieu (comme iay dict)	en ung seul lieu (comme j’ay dict)
songer ny alleguer miracle/ miracle:	songer ny alleguer miracle/ miracle:
poͬ le faire estre/ et le multiplier tout	pour le faire estre/ et le multiplier tout
en ung coup en plusieurs lieux. Car	en ung coup en plusieurs lieux. Car
ne/ sãs aucun fondemẽt. Et q̃ Dieu	ne/ sans aucun fondement. Et que Dieu
nauõs asseurãce descripture saincte	n’avons asseurance d’escripture saincte
ne promesse diuine.	ne promesse divine.
faire: ergo il le faict. Cela ne uault	faire: ergo il le faict. Cela ne vault
la puissance de Dieu: et est tout cer¬	la puissance de Dieu: et est tout cer¬
tain/ que Dieu est puissant de faire	tain/ que Dieu est puissant de faire
les qui sont au mõde (ainsi quil fist	les qui sont au monde (ainsi qu’il fist
foys il ne le faict pas.	foys il ne le faict pas.
Dauantage nous nauõs iamais	Davantage nous n’avons jamais
ayt multiplie et mis tout pour ung	ayt multiplie et mis tout pour ung
lieux: mais plus tost la faict trãspor	lieux: mais plus tost la faict transpor¬
ter soubdainement dung lieu en au¬	ter soubdainement d’ung lieu en au¬
de Abacuc/ qui par ung ange fut in¬	de Abacuc/ qui par ung ange fut in¬
lone: mais quand il estoit en ung	lone: mais quand il estoit en ung
lieu/ il laissoit lautre.	lieu/ il laissoit l’autre.
lippe/ apres auoir baptize le Eunuq̃	lippe/ apres avoir baptize le Eunuque
que lesperit de nostre Seigneur le ra	que l’esperit de nostre Seigneur le ra¬
uist soubdain/ ⁊ fut trouue en Azote.	vist soubdain/ et fut trouve en Azote.
en plusieͬs lieux tout en ung coup/	en plusieurs lieux tout en ung coup/
que Dieu face ung tel miracle/ sans	que Dieu face ung tel miracle/ sans
que on sen appercoyue/ sans rien	que on sen appercoyve/ sans rien
trop songe: car les oeuures de Dieu	trop songe: car les oeuvres de Dieu
mais ne fist miracle sur le corps de	mais ne fist miracle sur le corps de
quelcun/ sans le manifester. Les oeu	quelcun/ sans le manifester. Les oeu¬
(signantement quand elles cõcernẽt	(signantement quand elles concernent
dict/ claires ⁊ patẽtes: non seullemẽt	dict/ claires et patentes: non seullement
des corps humains/ mais aussi de	des corps humains/ mais aussi de
qͥ fut muee en uin: mais quãd leaue	qui fut muee en vin: mais quand l’eaue
de la uerge de Moyse qͥ fut muee en	de la verge de Moyse qui fut muee en
serpẽt/ ⁊ ainsi des autres. Dõc de	serpent/ et ainsi des autres. Donc de
corps de Iesuchrist/ sans euidence et	corps de Jesuchrist/ sans evidence et
Et cõtraindre le peuple a cela croi¬	Et contraindre le peuple a cela croi¬
re/ par feu/ par eaue/ par sang/ par	re/ par feu/ par eaue/ par sang/ par
cest cruellement tyrannize.	c’est cruellement tyrannize.
tification par la saincte escripture/ q̃	tification par la saincte escripture/ que
laduenemẽt du filz de lhomme/ sera	l’advenement du filz de l’homme/ sera
S. Matthieu: Se aucun uous dict:	Sainct Matthieu: Se aucun vous dict:
Car ainsi que lesclair sort Doriẽt/ et	Car ainsi que l’esclair sort D’orient/ et
apparoit iusque en Occident: ainsi	apparoit jusque en Occident: ainsi
Et de cela ont donne grand tesmoi¬	Et de cela ont donne grand tesmoi¬
quand ilz dirent aux apostres: Hom	quand ilz dirent aux apostres: Hom¬
mes de Galilee/ pourquoy uous ar¬	mes de Galilee/ pourquoy vous ar¬
Iesus qͥ est receu dauec uoꝰ au ciel/	Jesus qui est receu d’avec vous au ciel/
monter au ciel: cestadire/ apertemẽt/	monter au ciel: c’est a dire/ apertement/
uisiblement/ clairemẽt/ ⁊ manifeste¬	visiblement/ clairement/ et manifeste¬
ueloppe/ ou uestu ð pain ou de paste.	veloppe/ ou vestu de pain ou de paste.
sentend/ tant seulement de laduene¬	s’entend/ tant seulement de l’advene¬
ment au iour du iugemẽt: ⁊ non pas	ment au jour du jugement: et non pas
il demeure auec nous en corps ⁊ ame	il demeure avec nous en corps et ame
⁊ q̃ il ne se mõstre poĩt. Cela est ung	et que il ne se monstre point. Cela est ung
dict a plaisir/ dont on nous a abusez	dict a plaisir/ dont on nous a abusez
legiers a croire/ par cy deuant nous	legiers a croire/ par cy devant nous
Item cela dire/ est blasphemer et	Item cela dire/ est blasphemer et
faire Iesuchrist menteur/ qui a dict	faire Jesuchrist menteur/ qui a dict
iours des paoures auec nous: mais	jours des paovres avec nous: mais
Lesquelles parolles fault necessaire	Lesquelles parolles fault necessaire¬
ment entendre de son corps/ et de son	ment entendre de son corps/ et de son
rit/ il est par tout/ ⁊ tousiours auec	rit/ il est par tout/ et tousjours avec
Matthieu: Uoicy/ ie suis auec uous	Matthieu: Voicy/ je suis avec vous
tous les iours/ iusque a la cõsomma	tous les jours/ jusque a la consomma¬
Or est ce trop abesty et enchaine	Or est ce trop abesty et enchaine
lier ⁊ ainsi faire arrester a une chose	lier et ainsi faire arrester a une chose
uisible et corruptible/ pour illec cer¬	visible et corruptible/ pour illec cer¬
ieste. Car maintenant il est hors du	jeste. Car maintenant il est hors du
en le mettãt ⁊ tenant sans nul ordre	en le mettant et tenant sans nul ordre
⁊ positiõ/ ainsi en ung mõceau/ cache	et position/ ainsi en ung monceau/ cache
aneanty que iamais ne fut en la pre¬	aneanty que jamais ne fut en la pre¬
Mais ie demãde quelle utilite ou	Mais je demande quelle utilite ou
quel proffit/ nous pourroit il adue¬	quel proffit/ nous pourroit il adve¬
morceau de pain ainsi cache? quand	morceau de pain ainsi cache? quand
son pere que le sainct esperit ne uien¬	son pere que le sainct esperit ne vien¬
droit point: ⁊ quand il seroit monte	droit point: et quand il seroit monte
fist le iour cinquantiesme/ et tous¬	fist le jour cinquantiesme/ et tous¬
Brief ceste doctrine humaine/ est	Brief ceste doctrine humaine/ est
cause de la destruction uniuerselle	cause de la destruction universelle
pas pour donner quelque apparence	pas pour donner quelque apparence
ou ameinent ces parolles: Cecy est	ou ameinent ces parolles: Cecy est
mon corps/ qui est dõne pour uous.	mon corps/ qui est donne pour vous.
monstree/ que pain/ nõ pas uulgaire	monstree/ que pain/ non pas vulgaire
qui est ⁊ doibt estre pris en grande re	qui est et doibt estre pris en grande re¬
uerẽce/ en memoire de la mort ⁊ pas¬	verence/ en memoire de la mort et pas¬
dent amour/ ⁊ grande charite dont	dent amour/ et grande charite dont
dont il nous a uiuifiez. Signifiant	dont il nous a vivifiez. Signifiant
aussi lamour dont en uraye charite	aussi l’amour dont en vraye charite
tres/ comme membres dung mesme	tres/ comme membres d’ung mesme
Qui soit ainsi/ les mesmes parolles	Qui soit ainsi/ les mesmes parolles
le donnent a congnoistre. Car il est	le donnent a congnoistre. Car il est
le pain/ ou (ainsi qͥlz disent) la blan¬	le pain/ ou (ainsi qu’ilz disent) la blan¬
Iesuchrist.	Jesuchrist.
Parquoy si on me dit/ il est bien	Parquoy si on me dit/ il est bien
corps: mais soubz cela/ ou dedans	corps: mais soubz cela/ ou dedans
le corps/ Cest biẽ glose/ ⁊ trop chãge	le corps/ C’est bien glose/ et trop change
de propos/ ⁊ ne prent on pas les pa¬	de propos/ et ne prent on pas les pa¬
simplicite/ comme il les a proferees/	simplicite/ comme il les a proferees/
dit soubz cela/ ou dedans cela est con	dit soubz cela/ ou dedans cela est con¬
tenu mon corps: mais simplement il	tenu mon corps: mais simplement il
on disoit de laigneau paschal: Cecy	on disoit de l’aigneau paschal: Cecy
toutesfoys il est bien euident que lai¬	toutesfoys il est bien evident que l’ai¬
gneau nestoit poĩt le Passage: mais	gneau n’estoit point le Passage: mais
Passage. En ceste maniere aussi le	Passage. En ceste maniere aussi le
fie le corps/ cõme en autre lieu il est	fie le corps/ comme en autre lieu il est
dict q̃ Iesuchrist est la pierre: ⁊ neant	dict que Jesuchrist est la pierre: et neant
la pierre/ mais que par la pierre il	la pierre/ mais que par la pierre il
pos dict S. Augustin/ sur S. Iehan	pos dict Sainct Augustin/ sur Sainct Jehan
en ceste maniere. Res significantes acci	en ceste maniere. Res significantes acci¬
enim dicitur/ Petra significabat Christũ:	enim dicitur/ Petra significabat Christum:
En semblable maniere de parler il	En semblable maniere de parler il
disoit: Ie suis la uraye uigne/ cesta¬	disoit: Je suis la vraye vigne/ c’est a
Et que sur tout on doibt souueraine	Et que sur tout on doibt souveraine¬
a creu a la parolle du Seigñr Dieu/	a creu a la parolle du Seigneur Dieu/
⁊ il luy a este repute a iustice: ⁊ a este	et il luy a este repute a justice: et a este
De laquelle iustification/ ⁊ duquel	De laquelle justification/ et duquel
cõcision: ⁊ en ordonnãt iceluy signe/	concision: et en ordonnant iceluy signe/
le Seigneur Dieu luy disoit: Hoc est	le Seigneur Dieu luy disoit: Hoc est
tesfoys il est tres euidẽt que celle inci	tesfoys il est tres evident que celle inci¬
fut iamais iceluy accord: mais estoit	fut jamais iceluy accord: mais estoit
seullemẽt le signe de laccord. Par¬	seullement le signe de l’accord. Par¬
demandoye lintelligence parfaicte ⁊	demandoye l’intelligence parfaicte et
meum. Il me diroit: Hoc est signum	meum. Il me diroit: Hoc est signum
federis mei. Donc tout ainsi que il	federis mei. Donc tout ainsi que il
Hoc est signum federis mei. Ainsi ie luy	Hoc est signum federis mei. Ainsi je luy
est signum corporis mei. Car cest une	est signum corporis mei. Car c’est une
mesme maniere de parler si grande¬	mesme maniere de parler si grande¬
ses semblable/ qui nest hõe qui sceust	ses semblable/ qui n’est home qui sceust
Assez dautres passages il ya aux saĩ	Assez d’autres passages il y a aux sain¬
ctes escriptures/ ou telle maniere de	ctes escriptures/ ou telle maniere de
necessite de ainsi prendre durement a	necessite de ainsi prendre durement a
sans plus doulce intelligẽce misticq̃	sans plus doulce intelligence misticque
⁊ spirituelle: mais il a fallu aĩsi fai¬	et spirituelle: mais il a fallu ainsi fai¬
tion. Aussi affin que lydole de abomi	tion. Aussi affin que l’ydole de abomi¬
par cela lhõme dorgueil et de peche/	par cela l’homme d’orgueil et de peche/
celuy duquel laduenement est selon	celuy duquel l’advenement est selon
ce/ signes/ ⁊ miracles de mensonges/	ce/ signes/ et miracles de mensonges/
Notãmẽt le S. Apostre a dit signes	Notamment le Sainct Apostre a dit signes
⁊ miracles de mẽsonges. Car en ceste	et miracles de mensonges. Car en ceste
ges il a imagine. Nest ce pas biẽ son¬	ges il a imagine. N’est ce pas bien son¬
dens du pain ⁊ du uin/ cõme blan¬	dens du pain et du vin/ comme blan¬
cheur/ rotundite/ pesãteur/ goust/ sa¬	cheur/ rotundite/ pesanteur/ goust/ sa¬
la sans subiect/ cestadire sans fonde¬	la sans subject/ c’est a dire sans fonde¬
dimẽt parle de dire que on tient/ q̃ on	diment parle de dire que on tient/ que on
porte: ⁊ q̃ on enferme le corps de Ie¬	porte: et que on enferme le corps de Je¬
uiuant/ en chair ⁊ en os/ ainsi ⁊ la ou	vivant/ en chair et en os/ ainsi et la ou
De rechef ie demande que entend	De rechef je demande que entend
⁊ ueult dire le sacrificateur/ quand il	et veult dire le sacrificateur/ quand il
sant: Cecy est mon corps/ laissant le	sant: Cecy est mon corps/ laissant le
adioustant temerairement ce mot:	adjoustant temerairement ce mot:
enim/ disant: Hoc est enim corpus meũ.	enim/ disant: Hoc est enim corpus meum.
adiouste. En quoy il entreprend sus	adjouste. En quoy il entreprend sus
ce soit son propre corps de luy mesme	ce soit son propre corps de luy mesme
sacrificateur/ qui est cache soubz ceste	sacrificateur/ qui est cache soubz ceste
une orde ⁊ puãte chose. Se il respõd	une orde et puante chose. Se il respond
dit il donc/ Hoc est corpus Christi: affin	dit il donc/ Hoc est corpus Christi: affin
que on entendist ce que il ueult dire.	que on entendist ce que il veult dire.
te les parolles que Iesuchrist profe¬	te les parolles que Jesuchrist profe¬
ie respondz que parolles prinses ma	je respondz que parolles prinses ma¬
teriellemẽt (mesme selon leur doctri	teriellement (mesme selon leur doctri¬
signifient rien/ silz nen uouloiẽt fai¬	signifient rien/ s’ilz n’en vouloient fai¬
Dauantage/ ie leur demande ou	Davantage/ je leur demande ou
ilz ont promesse ⁊ asseurance de dieu	ilz ont promesse et asseurance de dieu
nõcerõt telles parolles/ que le corps	nonceront telles parolles/ que le corps
entre leurs mains. Se ilz alleguẽt	entre leurs mains. Se ilz alleguent
ce passage: Hoc facite in meam comme¬	ce passage: Hoc facite in meam comme¬
propos. Car il est tresmanifeste quil	propos. Car il est tres manifeste qu’il
mais parle de la comestiõ de ce pain	mais parle de la comestion de ce pain
qͥ doibt estre faicte en cõmemoration	qui doibt estre faicte en commemoration
christ/ en annonceant icelle (cõme dit	christ/ en annonceant icelle (comme dit
Cest ascauoir appertement ⁊ mani¬	C’est a scavoir appertement et mani¬
festemẽt au grand ⁊ dernier iour du	festement au grand et dernier jour du
a ce uerbe substãtif/ Sum/ es/ est/ uou	a ce verbe substantif/ Sum/ es/ est/ vou¬
lement/ puis quil a dit: Hoc est corpus	lement/ puis qu’il a dit: Hoc est corpus
meum. Car ce uerbe substantif/ com¬	meum. Car ce verbe substantif/ com¬
presence corporelle: mais biẽ assistẽce	presence corporelle: mais bien assistence
deux ou troys sont assemblez en mõ	deux ou troys sont assemblez en mon
nom/ la ie suis au millieu de eulx.	nom/ la je suis au millieu de eulx.
Et toutesfoys il est bien certain quil	Et toutesfoys il est bien certain qu’il
sinon son assistẽce spirituelle/ nõ pas	sinon son assistence spirituelle/ non pas
ꝑsonnelle ou corporelle/ cõme aucũs	personnelle ou corporelle/ comme aucuns
seullement Iesuchrist est en leucha¬	seullement Jesuchrist est en l’eucha¬
ame. Mais aussi (qͥ plus est) les an¬	ame. Mais aussi (qui plus est) les an¬
ges/ sainctz/ et sainctes/ et toute la	ges/ sainctz/ et sainctes/ et toute la
strent totallemẽt lefficace derreur ou	strent totallement l’efficace d’erreur ou
tendemẽt de cõgnoistre que eulx mes	tendement de congnoistre que eulx mes¬
mes se cõfondent. Car ainsi que par	mes se confondent. Car ainsi que par
corps de Iesuchrist en plusieͬs lieux	corps de Jesuchrist en plusieurs lieux
les anges/ tous les sainctz ⁊ sainctes	les anges/ tous les sainctz et sainctes
de Dieu/ soiẽt en plusieͬs lieux tout	de Dieu/ soient en plusieurs lieux tout
eshõtez de le cõceder/ ie leur demãde	eshontez de le conceder/ je leur demande
ont trouue cecy. Et comme ainsi soit	ont trouve cecy. Et comme ainsi soit
qui nen ayent point/ ie les deteste cõe	qui n’en ayent point/ je les deteste come
Et si on ameine le .ui. chapitre de	Et si on ameine le .vi. chapitre de
le pain uiuãt qui est descẽdu du ciel.	le pain vivant qui est descendu du ciel.
Si aucun mãge de ce pain/ il uiura	Si aucun mange de ce pain/ il vivra
est ma chair pour la uie du monde.	est ma chair pour la vie du monde.
gez la chair du filz de lhõe/ ⁊ si uous	gez la chair du filz de l’home/ et si vous
ne beuuez son sang/ uous ne aurez	ne beuvez son sang/ vous ne aurez
chair/ ⁊ boyt mon sang/ il a uie eter¬	chair/ et boyt mon sang/ il a vie eter¬
iour. Car ma chair est ueritablement	jour. Car ma chair est veritablement
uiãde/ ⁊ mon sang est ueritablemẽt	viande/ et mon sang est veritablement
que en tout ce chapitre Iesuchrist se	que en tout ce chapitre Jesuchrist se
est ⁊ estoit.	est et estoit.
Oultre/ uouloit oster la folle at¬	Oultre/ vouloit oster la folle at¬
le suyuoiẽt/ nõ pour autre chose sinõ	le suyvoient/ non pour autre chose sinon
lement sans plus labourer ne tra¬	lement sans plus labourer ne tra¬
uailler: pourtãt quil les auoit nour¬	vailler: pourtant qu’il les avoit nour¬
une foys/ ⁊ de sept a lautre/ aux de¬	une foys/ et de sept a l’autre/ aux de¬
au mesme chap̃.) le estimoiẽt filz de	au mesme chapitre) le estimoient filz de
Ioseph: et par ainsi le contẽnoient/	Joseph: et par ainsi le contennoient/
fust hõme/ ⁊ riẽ de diuinite en luy ne	fust homme/ et rien de divinite en luy ne
peult rassasier ⁊ nourrir noz ames ⁊	peult rassasier et nourrir noz ames et
esperitz. Parquoy affin qͥlz ne pre¬	esperitz. Parquoy affin qu’ilz ne pre¬
eussent excuse de peche/ il leur disoit:	eussent excuse de peche/ il leur disoit:
du ciel: cest adire/ par la seule miseri¬	du ciel: c’est a dire/ par la seule miseri¬
corde de mõ pere/ sans aucun merite	corde de mon pere/ sans aucun merite
Il disoit donc/ Ie suis le pain ui¬	Il disoit donc/ Je suis le pain vi¬
appertement il leur eust dict: Contẽ¬	appertement il leur eust dict: Contem¬
nez moy au dehors tãt q̃ uous uoul¬	nez moy au dehors tant que vous voul¬
sez. Uous uoyez le corps que uous	sez. Vous voyez le corps que vous
nitude de diuinite. Pourtant il sen¬	nitude de divinite. Pourtant il s’en¬
suyt: Le pain que ie donneray est ma	suyt: Le pain que je donneray est ma
grandement accõply par sa mort/ en	grandement accomply par sa mort/ en
luntairemẽt donne en sacrifice par¬	luntairement donne en sacrifice par¬
faict/ se offrãt dung ardẽt coeur poͬ	faict/ se offrant d’ung ardent coeur pour
propremẽt il appelle sa chair pain du	proprement il appelle sa chair pain du
son pere sont une mesme chose. En	son pere sont une mesme chose. En
laquelle signification le S. Apostre	laquelle signification le Saincte Apostre
autremẽt il ne seroit point nr̃e uie ⁊	autrement il ne seroit point notre vie et
nest point faict poͬ soy mesme/ mais	n’est point faict pour soy mesme/ mais
pour la nourriture dautruy: aussi Ie	pour la nourriture d’autruy: aussi Je¬
faict hõme pour nostre redẽption/ sa	faict homme pour nostre redemption/ sa¬
seuree ⁊ certaine cõfidence nous som	seuree et certaine confidence nous som¬
mes uniz ⁊ ioinctz a luy.	mes uniz et joinctz a luy.
tence tres certaine de ce chapitre est/	tence tres certaine de ce chapitre est/
⁊ charnelle: mais de la comestion spi	et charnelle: mais de la comestion spi¬
rituelle qui se faict par uiue/ entiere/	rituelle qui se faict par vive/ entiere/
Augustin: Ut quid paras dentem ⁊ uen	Augustin: Ut quid paras dentem et ven¬
quoy dispose tu les dentz ⁊ le uẽtre?	quoy dispose tu les dentz et le ventre?
Croy/ ⁊ tu las mange. Laquelle foy	Croy/ et tu l’as mange. Laquelle foy
Iesuchrist/ qui nous faict gouster sa	Jesuchrist/ qui nous faict gouster sa
claire en iceluy passage ou il dit: Les	claire en iceluy passage ou il dit: Les
parolles q̃ ie parle sont esperit ⁊ uie.	parolles que je parle sont esperit et vie.
la chair mãgee ⁊ aualee en son uẽtre	la chair mangee et avalee en son ventre
la croix attachee/ ⁊ au Seigñr Dieu	la croix attachee/ et au Seigneur Dieu
offerte ⁊ sacrifiee. Car certes la chair	offerte et sacrifiee. Car certes la chair
paruient point a lesperit. Et de dire	parvient point a l’esperit. Et de dire
seroit trop ridiculeusemẽt parle. Et	seroit trop ridiculeusement parle. Et
fault necessairemẽt entendre ce chapi	fault necessairement entendre ce chapi¬
sil ne plaist aux aduersaires resister	s’il ne plaist aux adversaires resister
deffẽdre leur fãtasie. Ce q̃ par le mes¬	deffendre leur fantasie. Ce que par le mes¬
me chap̃. il est facile de efficacement	me chapitre il est facile de efficacement
siderer. En ung passage il dict	siderer. En ung passage il dict
nelle/ ⁊ le resusciteray au dernier ioͬ.	nelle/ et le resusciteray au dernier jour.
En lautre passage il dict: Qui man	En l’autre passage il dict: Qui man¬
eternelle: ⁊ le resusciteray au dernier	eternelle: et le resusciteray au dernier
que par ses deux passages est simple	que par ses deux passages est simple¬
mẽt dict une mesme chose de la foy/	ment dict une mesme chose de la foy/
uenir a Iesuchrist/ le mãger ⁊ boire:	venir a Jesuchrist/ le manger et boire:
ꝓposition (cestascauoir q̃ quiconque	proposition (c’est a scavoir que quiconque
croit en Iesuchrist a la uie eternelle)	croit en Jesuchrist a la vie eternelle)
En uerite/ en uerite ie uous dis/ si	En verite/ en verite je vous dis/ si
lhõme/ ⁊ si uous ne beuuez son sãg/	l’homme/ et si vous ne beuvez son sang/
uous ne aurez poĩt uie en uous. Et	vous ne aurez point vie en vous. Et
qͥcõque croit en luy a la uie eternelle.	quiconque croit en luy a la vie eternelle.
que mãger la chair ⁊ boire le sang de	que manger la chair et boire le sang de
Iesuchrist/ uenir a luy/ et croire /en	Jesuchrist/ venir a luy/ et croire /en
Et nest hõme uiuãt/ tant soit subtil	Et n’est homme vivant/ tant soit subtil
dire du cõtraire. Et qui soit uray/ cõ	dire du contraire. Et qui soit vray/ com¬
bien de milles denfans/ ieunes/ ado¬	bien de milles d’enfans/ jeunes/ ado¬
sont/ ⁊ serõt/ en uie eternelle/ qui ia¬	sont/ et seront/ en vie eternelle/ qui ja¬
pain uisible/ ny ne beurẽt de ce calice.	pain visible/ ny ne beurent de ce calice.
Et toutesfois la ꝓpositiõ est gñalle	Et toutesfois la proposition est generalle
uoꝰ ne mãgez la chair du filz de lhõe	vous ne mangez la chair du filz de l’home
naurez point uie en uoꝰ. Parquoy	n’aurez point vie en vous. Parquoy
il est necessaire de prẽdre ⁊ entẽdre ce	il est necessaire de prendre et entendre ce
ble ⁊ exterieure: mais de la comestiõ	ble et exterieure: mais de la comestion
la seulle foy ouurãte par charite.	la seulle foy ouvrante par charite.
S. August. a biẽ entẽdu cecy quãd	Sainct Augustin a bien entendu cecy quand
il a ainsi escript: Illi putabant eroga¬	il a ainsi escript: Illi putabant eroga¬
in celum/ utiqꝫ integrum. Cum uideritis	in celum/ utique integrum. Cum videritis
filium hominis ascendentẽ ubi erat prius	filium hominis ascendenten ubi erat prius
do quo putatis erogat corpus suum/ uel	do quo putatis erogat corpus suum/ vel
sumitur morsibus. Item/ donec finiatur	sumitur morsibus. Item/ donec finiatur
seculum sur sum dñs est/ sed tamen hic no¬	seculum sur sum dominus est/ sed tamen hic no¬
resurrexit in uno loco esse oportet/ ueritas	resurrexit in uno loco esse oportet/ veritas
Les Iuifz pẽsoient q̃ Iesuchrist leur	Les Juifz pensoient que Jesuchrist leur
bailleroit son corps a mãger. Il leur	bailleroit son corps a manger. Il leur
roit au ciel/ affin quilz cõgneussent ⁊	roit au ciel/ affin qu’ilz congneussent et
quilz pensoiẽt ilz le receuroiẽt. Car sa	qu’ilz pensoient ilz le recevroient. Car sa
grace ne se cõsomme point par mor¬	grace ne se consomme point par mor¬
du monde le Seigñr est la sus: mais	du monde le Seigneur est la sus: mais
bas auec noꝰ. Car il fault q̃ le corps	bas avec nous. Car il fault que le corps
en quoy il est resuscite/ soit en ung	en quoy il est resuscite/ soit en ung
espand par tout.	espand par tout.
escrit ainsi: Absens erat celo scðm hu¬	escrit ainsi: Absens erat celo secundum hu¬
manam substãtiam quum esset in terra/ ⁊	manam substantiam quum esset in terra/ et
Scðm uero diuinã ⁊ immẽsam substantiã	Secundum vero divinam et immensam substantiam
nec terrã deserens quum ad celum ascẽdit.	nec terram deserens quum ad celum ascendit.
Cest adire/ Christ selon son humaine	C’est a dire/ Christ selon son humaine
estoit en la terre/ ⁊ estoit delaissãt la	estoit en la terre/ et estoit delaissant la
selon la diuine ⁊ infinie substãce/ ne	selon la divine et infinie substance/ ne
laissoit point le ciel quand il descẽdit	laissoit point le ciel quand il descendit
il monta au ciel.	il monta au ciel.
anciẽs docteurs/ nõ pas pour dõner	anciens docteurs/ non pas pour donner
auctorite/ ou par iceulx approuuer	auctorite/ ou par iceulx approuver
la puissance de la parolle de Dieu ne	la puissance de la parolle de Dieu ne
au ciel ne en la terre: ⁊ quand tout le	au ciel ne en la terre: et quand tout le
mõde seroit au cõtraire si demourera	monde seroit au contraire si demourera
tant seullement ie les ay bien uoulu	tant seullement je les ay bien voulu
uãt dict/ nestre point pour chose nou	vant dict/ n’estre point pour chose nou¬
uelle/ ainsi q̃ dõnẽt a entẽdre au peu¬	velle/ ainsi que donnent a entendre au peu¬
alleguẽt q̃ leurs mẽsonges ⁊ follies/	alleguent que leurs mensonges et follies/
sible par leurs gloses ⁊ traditiõs/ la	sible par leurs gloses et traditions/ la
saincte parolle de dieu/ selon laquelle	saincte parolle de dieu/ selon laquelle
dre papalle) deuãt dieu serõt iugez.	dre papalle) devant dieu seront jugez.
⁊ arreste/ reiectãt tout ce qui est dit ꝑ	et arreste/ rejectant tout ce qui est dit par
les hões en ce qui concerne les choses	les homes en ce qui concerne les choses
ctorite descripture/ selon laq̃lle tout	ctorite d’escripture/ selon laquelle tout
põdre/ rẽdre raison ⁊ satisfaire a tout	pondre/ rendre raison et satisfaire a tout
homme qui demande parolle de celle	homme qui demande parolle de celle
Donc puis quil est certain q̃ Iesu	Donc puis qu’il est certain que Jesu¬
le doibt cercher corꝑellemẽt en autre	le doibt cercher corꝑellement en autre
lieu iusq̃ a ce q̃ luy mesme uisiblemẽt	lieu jusque a ce que luy mesme visiblement
toute uerite descripture/ mais au ciel	toute verite d’escripture/ mais au ciel
mẽt ⁊ pẽsee: attendãt en hũble desir/	ment et pensee: attendant en humble desir/
lheure qͥ luy plaira en son repos noꝰ	l’heure qui luy plaira en son repos nous
en chose qui soit uisible: car lescriptu	en chose qui soit visible: car l’escriptu¬
Iesuchrist en ordõnãt sa saĩcte Cene	Jesuchrist en ordonnant sa saincte Cene
⁊ baillãt le pain a ses disciples/ disoit	et baillant le pain a ses disciples/ disoit
ne disoit point: Respicite adorate/ Ne	ne disoit point: Respicite adorate/ Ne
le peuple a telle adoratiõ/ cõe depuis	le peuple a telle adoration/ come depuis
aucun tẽps on a faict: mais cest chose	aucun temps on a faict: mais c’est chose
adoratiõ q̃ on doibt au seul dieu/ leq̃l	adoration que on doibt au seul dieu/ lequel
soit donne ⁊ baille aux choses uisi¬	soit donne et baille aux choses visi¬
bles cõme en toutes natiõs/ en tous	bles comme en toutes nations/ en tous
este ueu. De cecy les histoires tant	este veu. De cecy les histoires tant
ainsi qͥl appert en Exode des Egy¬	ainsi qu’il appert en Exode des Egy¬
ptiens/ en Daniel des Babyloniẽs/	ptiens/ en Daniel des Babyloniens/
ainsi des autres.	ainsi des autres.
tãt prõpt ⁊ enclin a idolatrie/ q̃ mes¬	tant prompt et enclin a idolatrie/ que mes¬
me le peuple qͥ estoit nõme peuple de	me le peuple qui estoit nomme peuple de
diceluy/ par laq̃lle tres fortemẽt tou	d’iceluy/ par laquelle tres fortement tou¬
tant de foys tumbe en idolatrie/ q̃ il	tant de foys tumbe en idolatrie/ que il
est ĩpossible le pẽser: cõe il appert au	est impossible le penser: come il appert au
de Paralipomenõ/ de Ieremie/ ⁊ au¬	de Paralipomenon/ de Jeremie/ et au¬
plꝰ petis ⁊ moins scauãs: mais aussi	plus petis et moins scavans: mais aussi
les principaulx ⁊ souuerains du peu	les principaulx et souverains du peu¬
roboam/ ⁊ plusieurs autres. Le plus	roboam/ et plusieurs autres. Le plus
bien/ ⁊ q̃lque deuotion: par telle sorte	bien/ et quelque devotion: par telle sorte
q̃ a grãde difficulte on eust sceu reiet	que a grande difficulte on eust sceu rejet¬
maxime/ que tout fidele doibt auoir	maxime/ que tout fidele doibt avoir
coeur: de laq̃lle se il se laisse destour¬	coeur: de laquelle se il se laisse destour¬
ner pour q̃lconque raison q̃ ce soit/ in¬	ner pour quelconque raison que ce soit/ in¬
niẽs/ ⁊ infiniz erreurs. La maxime ⁊	niens/ et infiniz erreurs. La maxime et
uõs point faire ce qͥl nous sẽble bon:	vons point faire ce qu’il nous semble bon:
mais ce q̃ la parolle de Dieu dit. A	mais ce que la parolle de Dieu dit. A
ster/ rien diminuer ou chãger: cõbien	ster/ rien diminuer ou changer: combien
il est escrit: Ne uueillez cheminer es	il est escrit: Ne vueillez cheminer es
cõmãdemẽs de uoz peres/ ne gardez	commandemens de voz peres/ ne gardez
mes cõmãdemẽs/ ⁊ gardez mes iuge	mes commandemens/ et gardez mes juge¬
a ꝑditiõ/ tout tumbe en erreur/ mẽsõ	a perditions/ tout tumbe en erreur/ menson¬
ge/ ⁊ deception/ ⁊ a bon droict. Car si	ge/ et deception/ et a bon droict. Car si
mort: si on delaisse uerite/ il fault ne	mort: si on delaisse verite/ il fault ne¬
cecy noꝰ auõs ung merueilleux exẽ	cecy nous avons ung merveilleux exem¬
ple/ du serpent daerain q̃ Moyse par	ple/ du serpent d’aerain que Moyse par
affin q̃ en le regardant/ le peuple qui	affin que en le regardant/ le peuple qui
bruslãs/ fust preserue de la mort: leq̃l	bruslans/ fust preserve de la mort: lequel
serpent leue en hault estoit la figure	serpent leve en hault estoit la figure
che ⁊ leue au boys: cõme luy mesme a	che et leve au boys: comme luy mesme a
Or pẽsez cõbien iceluy serpẽt dae¬	Or pensez combien iceluy serpent d’ae¬
rain deuoit estre estime a tout ce peu¬	rain devoit estre estime a tout ce peu¬
este faict par inuẽtion dhõme: mais	este faict par invention d’homme: mais
au seul regard diceluy/ ilz estoiẽt pre	au seul regard d’iceluy/ ilz estoient pre¬
seruez de grandz perilz ⁊ dangereux	servez de grandz perilz et dangereux
la par successiõ de tẽps/ poͬ telles rai	la par succession de temps/ pour telles rai¬
parẽtes ⁊ plaisãtes a la chair: il ad¬	parentes et plaisantes a la chair: il ad¬
uint q̃ on le uint a encẽser/ ⁊ publicq̃¬	vint que on le vint a encenser/ et publicque¬
faict parmy les tẽples ⁊ mõstiers les	faict parmy les temples et monstiers les
biẽ faire leur debuoir/ attẽdu les cho	bien faire leur debvoir/ attendu les cho¬
ses predictes. Laq̃lle chose dura ⁊ fut	ses predictes. Laquelle chose dura et fut
du bon Roy Ezechie. Leq̃l mene par	du bon Roy Ezechie. Lequel mene par
struire: non pas certes sans murmu¬	struire: non pas certes sans murmu¬
re de plusieͬs: mais le bon Roy regar	re de plusieurs: mais le bon Roy regar¬
nõ pas ce q̃ la multitude uouloit ⁊ de	non pas ce que la multitude vouloit et de¬
Or est il ainsi que Dieu ne auoit	Or est il ainsi que Dieu ne avoit
point dict q̃ on le adorast/ ⁊ que on le	point dict que on le adorast/ et que on le
gardast. Et pourtãt q̃ ilz auoiẽt ad¬	gardast. Et pourtant que ilz avoient ad¬
garder/ que aussi il fust encẽse a bon	garder/ que aussi il fust encense a bon
droict le sage Roy/ le feit destruire et	droict le sage Roy/ le feit destruire et
nant ung image tel qͥl estoit/ cestadi	nant ung image tel qu’il estoit/ c’est a di¬
fussent faictes. Urayement il seroit	fussent faictes. Vrayement il seroit
biẽ encẽse/ bien uestu/ biẽ pare/ on luy	bien encense/ bien vestu/ bien pare/ on luy
des ⁊ chãdelles/ ueu que on en faict	des et chandelles/ veu que on en faict
Dieu ne ordõna: mais au cõtraire q̃	Dieu ne ordonna: mais au contraire que
il a grandement deffendues.	il a grandement deffendues.
digression: ie uoꝰ prie/ dont est uenu	digression: je vous prie/ dont est venu
dace/ de leuer en hault ⁊ monstrer au	dace/ de lever en hault et monstrer au
peuple ung peu de pain pour le faire	peuple ung peu de pain pour le faire
nẽ parla. Et aussi les apostres quãd	n’en parla. Et aussi les apostres quand
adorerẽt poĩt: mais seulemẽt le prin¬	adorerent point: mais seulement le prin¬
drent/ ⁊ mangerẽt: ainsi qͥ leur disoit	drent/ et mangerent: ainsi qui leur disoit
disoit poĩt/ Regardez/ adorez. Certai	disoit point/ Regardez/ adorez. Certai¬
maine/ qͥ ꝓphane les choses de dieu.	maine/ qui prophane les choses de dieu.
Las quand sera ce q̃ Dieu nous su¬	Las quand sera ce que Dieu nous su¬
chie: leq̃l en la uertu de Dieu destrui	chie: lequel en la vertu de Dieu destrui¬
trie. Le Seigneur en sa misericorde	trie. Le Seigneur en sa misericorde
uueille regarder son paoure peuple/	vueille regarder son paovre peuple/
latrie le deliurer et purger. Amen.	latrie le delivrer et purger. Amen.
transsubstantiation/ ie men deporte:	transsubstantiation/ je m’en deporte:
car cest une chose folle/ inuẽtee ⁊ son	car c’est une chose folle/ inventee et son¬
tenu compte de sainctes escriptures.	tenu compte de sainctes escriptures.
de Dieu. Les peres de la p̃miere egli	de Dieu. Les peres de la premiere egli¬
se nont point ainsi parle: mais ceulx	se n’ont point ainsi parle: mais ceulx
uãs q̃ saĩct Iehã/ S. Luc/ S. Marc/	vans que sainct Jehan/ Sainct Luc/ Sainct Marc/
pleins de foy ⁊ cõgnoissãce de Dieu.	pleins de foy et congnoissance de Dieu.
Neantmoins (et ne leur desplaise) il	Neantmoins (et ne leur desplaise) il
S. Paul/ que ainsi grand clerc/ auec	Sainct Paul/ que ainsi grand clerc/ avec
Quãt a la Messe/ on scait biẽ dõt	Quant a la Messe/ on scait bien dont
elle est procedee: ⁊ ne fault pas grãd	elle est procedee: et ne fault pas grand
ordonnãce de Dieu: mais seulement	ordonnance de Dieu: mais seulement
nies/ qͥ peu a peu ꝑ successiõ de tẽps	nies/ qui peu a peu par succession de temps
a plusieurs foys ⁊ de plusieurs per¬	a plusieurs foys et de plusieurs per¬
see: au lieu de la saincte Cene de Iesu	see: au lieu de la saincte Cene de Jesu¬
aussi par linsipiẽce des ignorãs: car	aussi par l’insipience des ignorans: car
ignorãce a este ⁊ est tousioͬs mere de	ignorance a este et est tousjours mere de
Quil soit ainsi/ Platina le mõstre	Qu’il soit ainsi/ Platina le monstre
fes/ quand il parle de Sixte premier	fes/ quand il parle de Sixte premier
de ce nom/ la ou il dit/ q̃ Celestin or¬	de ce nom/ la ou il dit/ que Celestin or¬
son: Telesphorus/ Gloria ĩ excelsis:	son: Telesphorus/ Gloria in excelsis:
Lepistre ⁊ Leuãgile. Alleluya a este	L’epistre et L’evangile. Alleluya a este
prins ð leglise de Ierusalẽ. Le Sym	prins de l’eglise de Jerusalem. Le Sym¬
cile de Nicene: il sentend pour la pre¬	cile de Nicene: il s’entend pour la pre¬
niere partie/ depuis ce lieu la/ Et ĩ spi	niere partie/ depuis ce lieu la/ Et in spi¬
ritum sanctum dominum/ est prins du	ritum sanctum dominum/ est prins du
donius. Pelagius se aduisa le pre¬	donius. Pelagius se advisa le pre¬
⁊ est celuy qui plus a rẽply ⁊ engresse	et est celuy qui plus a remply et engresse
ceste Messe de richesses/ ainsi q̃ main¬	ceste Messe de richesses/ ainsi que main¬
iouste Lencens. Sixte premier de ce	jouste L’encens. Sixte premier de ce
de ce nom/ ĩuẽta baiser la Paix. Ser	de ce nom/ inventa baiser la Paix. Ser¬
giꝰ ordõna le Agnꝰ dei. Et ainsi du	gius ordonna le Agnus dei. Et ainsi du
tiõs/ luminaires/ sõneries de cloches	tions/ luminaires/ sonneries de cloches
blables. Lesquelles choses seroient	blables. Lesquelles choses seroient
trop longues a reciter: mais iay bien	trop longues a reciter: mais j’ay bien
que on entẽde q̃ Iesuchrist ⁊ les Apo	que on entende que Jesuchrist et les Apo¬
ou enseigne: ⁊ q̃ tout cecy est inuẽtiõ	ou enseigne: et que tout cecy est invention
humaine/ pour plus a son aise passer	humaine/ pour plus a son aise passer
de ou erudition. Et pour tout dire/	de ou erudition. Et pour tout dire/
chãtant/ puissent uiure sans soucy.	chantant/ puissent vivre sans soucy.
Uoicy le mal qͥ tãt les estõne se ilz	Voicy le mal qui tant les estonne se ilz
rabaisser leur estat. Et pourtant ilz	rabaisser leur estat. Et pourtant ilz
peuuẽt/ allegans le tẽps passe/ leurs	peuvent/ allegans le temps passe/ leurs
peres/ ⁊ la coustume. Mais en ung	peres/ et la coustume. Mais en ung
rite: non point coustume/ cõbien lon¬	rite: non point coustume/ combien lon¬
fondee en uerite.	fondee en verite.
Et pourtant en la uertu du nom	Et pourtant en la vertu du nom
quiers a tout le mõde/ Signãtemẽt	quiers a tout le monde/ Signantement
tẽt le nom de Dieu/ duq̃l tiennent le	tent le nom de Dieu/ duquel tiennent le
glaiue ⁊ la puissãce: auoir icy regard	glaive et la puissance: avoir icy regard
qui est sus tout dauoir lhonneur de	qui est sus tout d’avoir l’honneur de
⁊ punissans les malfaicteurs: ainsi	et punissans les malfaicteurs: ainsi
que la parolle de Dieu ordonne.	que la parolle de Dieu ordonne.
la loy de Dieu en sõ coeur escrite/ sãs	la loy de Dieu en son coeur escrite/ sans
iustemẽt regir ⁊ gouuerner le peuple	justement regir et gouverner le peuple
qͥ luy est baille en charge. Et sur tout	qui luy est baille en charge. Et sur tout
les officiers de sõ royaume/ singulie	les officiers de son royaume/ singulie¬
ceulx principallemẽt depend le bien	ceulx principallement depend le bien
ou le mal de tout le peuple: ⁊ nõ seu¬	ou le mal de tout le peuple: et non seu¬
aussi lhõneur ou la cõfusiõ du Prĩce	aussi l’honneur ou la confusion du Prince
aucun estre constitue en puissance ou	aucun estre constitue en puissance ou
auctorite/ qui soit ambitieux ou aua	auctorite/ qui soit ambitieux ou ava¬
tout ce qui fera/ tout son cõseil/ tout	tout ce qui fera/ tout son conseil/ tout
pour ꝑuenir a ses fins. Uoire mais	pour parvenir a ses fins. Voire mais
par telz moyẽs q̃ bien difficile est sen	par telz moyens que bien difficile est s’en
qui le cõgnoit cest le Prĩce: car telles	qui le congnoit c’est le Prince: car telles
feinctes/ entretiẽnent ⁊ endormẽt le	feinctes/ entretiennent et endorment le
Prince tellemẽt quil est cõme captif	Prince tellement qu’il est comme captif
scauent bien faire leurs besongnes.	scavent bien faire leurs besongnes.
ou petis/ sõt traistres a Dieu/ au prĩ	ou petis/ sont traistres a Dieu/ au prin¬
ce/ ⁊ a tout le mõde. Et ꝑ iceulx uiẽt	ce/ et a tout le monde. Et par iceulx vient
quelque cent ou cinquante mille/ ou	quelque cent ou cinquante mille/ ou
biẽ secretemẽt empõgner/ ilz coppẽt/	bien secretement empongner/ ilz coppent/
ilz taillent ilz font/ ilz desfont/ ilz rõ	ilz taillent ilz font/ ilz desfont/ ilz rom¬
mens/ cõiunctions/ ⁊ alliãces telles	mens/ conjunctions/ et alliances telles
bon/ pour eulx: car a cela tend toute	bon/ pour eulx: car a cela tend toute
leͬ estude/ ⁊ nõt iamais autre soucy.	leur estude/ et n’ont jamais autre soucy.
Princes ⁊ Roys/ eussẽt tousioͬs de¬	Princes et Roys/ eussent tousjours de¬
au bõ seruiteur de Dieu Moyse/ par	au bon serviteur de Dieu Moyse/ par
Iethro: lequel dist en ceste maniere:	Jethro: lequel dist en ceste maniere:
le peuple hões uertueux ⁊ craĩgnãs	le peuple homes vertueux et craingnans
auarice. Et diceulx ꝯstitue officiers/	avarice. Et d’iceulx constitue officiers/
capitaines ⁊ cẽteniers/ cinquãteniers	capitaines et centeniers/ cinquanteniers
en tout tẽps ⁊ a toute heure. Et sil est	en tout temps et a toute heure. Et s’il est
ras la cõgnoissance/ iceulx iugeront	ras la congnoissance/ iceulx jugeront
tant seulement les petites choses.	tant seulement les petites choses.
lequel sil estoit biẽ obserue des Prin¬	lequel s’il estoit bien observe des Prin¬
te diuine et humaine.	te divine et humaine.
La sõme du cõseil pend principale	La somme du conseil pend principale¬
persõnages amateͬs de uerite (les¬	personnages amateurs de verite (les¬
soiẽt cõstituez en maistrise/ en office/	soient constituez en maistrise/ en office/
⁊ auctorite. Car silz sõt appetãs gloi	et auctorite. Car s’ilz sont appetans gloi¬
scait cõe le mõde sera gouuerne: car	scait come le monde sera gouverne: car
yeulx/ mesme des sages. Et Salo¬	yeulx/ mesme des sages. Et Salo¬
mon dit q̃ lhõme auaricieux destrui¬	mon dit que l’homme avaricieux destrui¬
en la cite. Et pour dire en ung bref	en la cite. Et pour dire en ung bref
que ung auaricieux constitue en au¬	que ung avaricieux constitue en au¬
torite. Lequel certes on peult	torite. Lequel certes on peult
uoir iamais contẽtemẽt/ ⁊ q̃lque bien	voir jamais contentement/ et quelque bien
⁊ rassasie/ tousioͬs aspire a plꝰ grãdz	et rassasie/ tousjours aspire a plus grandz
choses/ tousioͬs desire estre plꝰ hault	choses/ tousjours desire estre plus hault
tous autres/ autãt quil peult: uoire	tous autres/ autant qu’il peult: voire
La secõde chose principalemẽt tou	La seconde chose principalement tou¬
chee en ce diuin cõseil de Iethro/ est q̃	chee en ce divin conseil de Jethro/ est que
escouter les causes ⁊ affaires de son	escouter les causes et affaires de son
uray pere. Et que on ayt acces a luy	vray pere. Et que on ayt acces a luy
pour luy dõner entẽdre les affaires/	pour luy donner entendre les affaires/
paoures gẽs/ ainsi delaissez du Prin	paovres gens/ ainsi delaissez du Prin¬
ciers? Et certes si iamais fut besoing	ciers? Et certes si jamais fut besoing
⁊ grãde necessite de auoir acces facile	et grande necessite de avoir acces facile
tãt pour liniquite de plusieurs offi¬	tant pour l’iniquite de plusieurs offi¬
tant ardue/ ⁊ tãt digne de estre exa¬	tant ardue/ et tant digne de estre exa¬
minee ⁊ congneue des Princes que	minee et congneue des Princes que
Il nest point q̃stion seulemẽt des	Il n’est point question seulement des
tant de lieux sont traictez piremẽt q̃	tant de lieux sont traictez pirement que
ne seroiẽt paoures brebis des loups	ne seroient paovres brebis des loups
seulement le ueoir: mais aussi le dire	seulement le veoir: mais aussi le dire
Mais il est q̃stiõ de la cause/ affin	Mais il est question de la cause/ affin
que Dieu ne soit point ainsi blasphe	que Dieu ne soit point ainsi blasphe¬
primee. Si quelcun parle ung seul	primee. Si quelcun parle ung seul
Uoila la deffense des iniques/ sa cau	Voila la deffense des iniques/ sa cau¬
se sera uẽtilee a part ⁊ en secret/ affin	se sera ventilee a part et en secret/ affin
Ie pose bien q̃ le Prince dira de bou¬	Je pose bien que le Prince dira de bou¬
pour sa descharge deuãt Dieu ne suf	pour sa descharge devant Dieu ne suf¬
fist point. Car soubz lombre dũg tel	fist point. Car soubz l’ombre d’ung tel
uolunte/ les innocẽs sont opprimez/	volunte/ les innocens sont opprimez/
Salomon quand il sest gouuerne	Salomon quand il s’est gouverne
par la sagesse de Dieu il a ꝓspere/ ⁊	par la sagesse de Dieu il a prospere/ et
on puisse trouuer auoir este faictz/	on puisse trouver avoir este faictz/
chascũ auoir acces a luy/ sãs aucune	chascun avoir acces a luy/ sans aucune
acception de ꝑsonnes/ ne croyãt rien	acception de personnes/ ne croyant rien
Nestant point cõme aucuns (peut	N’estant point comme aucuns (peut
ausquelz iamais on ne peult auoir	ausquelz jamais on ne peult avoir
acces pour exposer ⁊ dire son cas/ les	acces pour exposer et dire son cas/ les¬
tel Roy si noble/ tant riche/ tãt excel	tel Roy si noble/ tant riche/ tant excel¬
mesme ouyr la cause de deux putaĩs.	mesme ouyr la cause de deux putains.
Car il cõgnoissoit bien q̃ cela ne uiẽt	Car il congnoissoit bien que cela ne vient
des hõmes qͥ sont sur la terre/ q̃ ung	des hommes qui sont sur la terre/ que ung
obey: mais q̃ cest la uertu ⁊ puissance	obey: mais que c’est la vertu et puissance
de Dieu qͥ cõmande ⁊ ueult que les	de Dieu qui commande et veult que les
tant il uouloit honnorer celuy par qͥ	tant il vouloit honnorer celuy par qui
raison ueult q̃ ung chascun en ce mõ	raison veult que ung chascun en ce mon¬
de hõnore son superieur: cõbien plus	de honnore son superieur: combien plus
tout bon/ tout sage/ ⁊ seul tout puis¬	tout bon/ tout sage/ et seul tout puis¬
bauldes luy a este tant precieuse que	bauldes luy a este tant precieuse que
luy mesme la ouye: cõbien plus de¬	luy mesme la ouye: combien plus de¬
mes ouyr la cause de Leuãgile/ qͥ cer	mes ouyr la cause de L’evangile/ qui cer¬
pas la cõmettre ainsi a la uolunte ie	pas la commettre ainsi a la volunte je
ne scay de q̃lz enchaperõnez/ ⁊ autres	ne scay de quelz enchaperonnez/ et autres
affectez: lesq̃lz sont iuges ⁊ partie?	affectez: lesquelz sont juges et partie?
⁊ Roys que le sang innocẽt ainsi ini¬	et Roys que le sang innocent ainsi ini¬
quemẽt respãdu sera requis de leurs	quement respandu sera requis de leurs
par les yeulx dautruy/ ne ouyr par	par les yeulx d’autruy/ ne ouyr par
me doyuent ouyr ⁊ entẽdre la cause/	me doyvent ouyr et entendre la cause/
signãtement quãd elle est de si grãde	signantement quand elle est de si grande
horreur de abãdõner ⁊ liurer/ les hũ¬	horreur de abandonner et livrer/ les hum¬
aux puissans/ les sobres aux yuron	aux puissans/ les sobres aux yvron¬
gnes/ les seruiteͬs de Iesuchrist aux	gnes/ les serviteurs de Jesuchrist aux
ainsi tuez/ meurtris ⁊ bruslez? Est ce	ainsi tuez/ meurtris et bruslez? Est ce
A tout le moins se ilz feissent au¬	A tout le moins se ilz feissent au¬
tant pour Iesuchrist qui est leur sou	tant pour Jesuchrist qui est leur sou¬
pour son dieu Baal/ qui assembla	pour son dieu Baal/ qui assembla
contre Helie/ ilz feroient leur office.	contre Helie/ ilz feroient leur office.
Cest/ que ilz feissent assembler les	C’est/ que ilz feissent assembler les
secuteurs/ contre ceulx qui sont ainsi	secuteurs/ contre ceulx qui sont ainsi
sa raison/ sans aucune faueur. Alors	sa raison/ sans aucune faveur. Alors
facilemẽt on congnoistroit ceulx qui	facilement on congnoistroit ceulx qui
tort: ⁊ seroit le peuple en paix edifie/	tort: et seroit le peuple en paix edifie/
scandale. Et seroit la suspicion ⁊ re¬	scandale. Et seroit la suspicion et re¬
mors de leurs consciences ostee: car	mors de leurs consciences ostee: car
estre qͥlz ne soient doubteux de q̃lque	estre qu’ilz ne soient doubteux de quelque
totallement alienez de Dieu/ et mis	totallement alienez de Dieu/ et mis
en sẽs reprouue/ ce q̃ dieu ne ꝑmette.	en sens reprouve/ ce que dieu ne permette.
est uiole/ toutes choses quasi pour la	est viole/ toutes choses quasi pour la
en la haine de leuangile.	en la haine de l’evangile.
Que ne faict on a tout le moins	Que ne faict on a tout le moins
tiere ⁊ chose de la foy fault auoir re¬	tiere et chose de la foy fault avoir re¬
tenãt les hõmes tãt impudẽs qui cõ	tenant les hommes tant impudens qui con¬
tredisent a cecy/ ⁊ refusent le concile?	tredisent a cecy/ et refusent le concile?
depuis que le mõde est cree/ auquel il	depuis que le monde est cree/ auquel il
nãt/ pour mettre toutes choses en bõ	nant/ pour mettre toutes choses en bon¬
ne unite. On ne scait que deuenir/ on	ne unite. On ne scait que devenir/ on
uer/ tant est le monde diuise. Il nest	ver/ tant est le monde divise. Il n’est
hõme de uertu ⁊ de scauoir/ de parler	homme de vertu et de scavoir/ de parler
ung mot de uerite/ poͬ la crainte de	ung mot de verite/ pour la crainte de
rent que le sang.	rent que le sang.
dõnez uous ordre a cecy? A uous il	donnez vous ordre a cecy? A vous il
appartient/ cest uostre droict office.	appartient/ c’est vostre droict office.
prier de tenir le Cõcile/ cest une chose	prier de tenir le Concile/ c’est une chose
qͥl tarde il fault qͥl soit faict. Et ne	qu’il tarde il fault qu’il soit faict. Et ne
fault pas pẽser q̃ tous les sages hu¬	fault pas penser que tous les sages hu¬
pescher ung tel acte/ par ꝑsecutions	pescher ung tel acte/ par persecutions
impostures ⁊ mẽsonges: car la main	impostures et mensonges: car la main
de Dieu y est. Ce nest point en ung	de Dieu y est. Ce n’est point en ung
seulemẽt/ cest par toute la terre. Et	seulement/ c’est par toute la terre. Et
en q̃lq̃ lieu/ uoire de mille ⁊ mille/ on	en quelque lieu/ voire de mille et mille/ on
ne mettra pas fin a cecy/ il nest possi	ne mettra pas fin a cecy/ il n’est possi¬
la uengeance et fureur de Dieu.	la vengeance et fureur de Dieu.
se tiẽdra quoy quil tarde) le droict se	se tiendra quoy qu’il tarde) le droict se
treuue de la part de leuãgile: cest adi	treuve de la part de l’evangile: c’est a di¬
uagile de Iesuchrist sont persecutez/	vangile de Jesuchrist sont persecutez/
ne sera pas tẽps de sen repẽtir/ on ne	ne sera pas temps de s’en repentir/ on ne
resuscitera pas les mortz pourtãt/ et	resuscitera pas les mortz pourtant/ et
le sang espãdu a tort/ sera tousiours	le sang espandu a tort/ sera tousjours
que on est assez admonneste.	que on est assez admonneste.
Nest ce pas merueilles que les sa¬	N’est ce pas merveilles que les sa¬
biẽ ⁊ disent/ que il y a beaucop dabuz	bien et disent/ que il y a beaucop d’abuz
corrige ung seul iotta? mais qͥ plus	corrige ung seul iotta? mais qui plus
est uont tousiours de mal en pis/ on	est vont tousjours de mal en pis/ on
Parquoy il est biẽ a craindre qui sur¬	Parquoy il est bien a craindre qui sur¬
tost on ny remedie.	tost on n’y remedie.
Pouruoyez y Princes chrestiens	Pourvoyez y Princes chrestiens
ne permettez plus uerite estre aĩsi cõ	ne permettez plus verite estre ainsi con¬
de Iesuchrist estre aĩsi affligez ⁊ tor¬	de Jesuchrist estre ainsi affligez et tor¬
mẽtez: lesquelz certes sont si cruel¬	mentez: lesquelz certes sont si cruel¬
urez/ q̃ tout le mõde de grosse paour	vrez/ que tout le monde de grosse paour
on le Cõcile ueritable ⁊ legitime/ a la	on le Concile veritable et legitime/ a la
declaratiõ duquel bien humblemẽt ⁊	declaration duquel bien humblement et
se submettẽt? Et certes il est bien	se submettent? Et certes il est bien
puis quilz craingnẽt/ quilz resistent	puis qu’ilz craingnent/ qu’ilz resistent
⁊ cõtredisẽt au Cõcile. Et pourtãt	et contredisent au Concile. Et pourtant
fureur/ a tout le moins iusque a la	fureur/ a tout le moins jusque a la
soit pas concede pour ung seul mot/	soit pas concede pour ung seul mot/
de ainsi exercer leur forsenerie/ sur	de ainsi exercer leur forsenerie/ sur
Cest chose admirable quil ne soit	C’est chose admirable qu’il ne soit
autãt pour les paoures ames rache¬	autant pour les paovres ames rache¬
tees du sang de Iesuchrist cõme il est	tees du sang de Jesuchrist comme il est
Si on uoyoit ung loup aux chãps	Si on voyoit ung loup aux champs
cryer ⁊ de faict/ chascun cryeroit ap̃s	cryer et de faict/ chascun cryeroit apres
sans aucune reprehension. Helas on	sans aucune reprehension. Helas on
abuseurs qui seduysent et tiẽnent en	abuseurs qui seduysent et tiennent en
Ne oseroit on dõc cryer apres/ ⁊ par¬	Ne oseroit on donc cryer apres/ et par¬
ler alencõtre/ urayement cest tout le	ler a l’encontre/ vrayement c’est tout le
tant de ma part (si Dieu me ayde)	tant de ma part (si Dieu me ayde)
que ie pourray/ iusque a la mort/ ⁊ ia	que je pourray/ jusque a la mort/ et ja¬
mais ne cesseray tant que on y aura	mais ne cesseray tant que on y aura
plus de cent mille autres auec moy.	plus de cent mille autres avec moy.
freres/ est de se prosterner en la p̃sẽce	freres/ est de se prosterner en la presence
de Dieu ⁊ profundemẽt humilier en	de Dieu et profundement humilier en
cesser luy fault demander que en sa	cesser luy fault demander que en sa
luy plaise uisiter son paoure peuple/	luy plaise visiter son paovre peuple/
le retirãt de tout erreur/ de tenebres/	le retirant de tout erreur/ de tenebres/
Prians aussi tous dung coeur et	Prians aussi tous d’ung coeur et
de tous seigneurs/ le dominateur et	de tous seigneurs/ le dominateur et
prince de tous les Roys de la terre/	prince de tous les Roys de la terre/
il luy plaise totallemẽt incliner leͬs	il luy plaise totallement incliner leurs
suyure/ ⁊ parfaictement aymer toute	suyvre/ et parfaictement aymer toute
uerite de Dieu: affin quil soit par	verite de Dieu: affin qu’il soit par
ple qui leur est commis/ soit conduict	ple qui leur est commis/ soit conduict
te paix ⁊ charite/ ainsi que il appar¬	te paix et charite/ ainsi que il appar¬
tient/ Le tout a lhonneur ⁊ louenge	tient/ Le tout a l’honneur et louenge
nous uiuons et toutes choses con¬	nous vivons et toutes choses con¬
A cecy nous admõneste ⁊ exhorte	A cecy nous admonneste et exhorte
le sainct Apostre/ disant ainsi: Donc	le sainct Apostre/ disant ainsi: Donc
choses on face supplications/ orai¬	choses on face supplications/ orai¬
pour tous les hõmes/ pour les Roys	pour tous les hommes/ pour les Roys
⁊ tous ceulx qui sont constituez en di	et tous ceulx qui sont constituez en di¬
⁊ trãquille/ en toute sainctete ⁊ chaste	et tranquille/ en toute sainctete et chaste¬
Dieu nostre sauueur qui ueult que	Dieu nostre sauveur qui veult que
tous hommes soyent sauuez/ ⁊ quilz	tous hommes soyent sauvez/ et qu’ilz
rite. Dont Dieu pere de misericor¬	rite. Dont Dieu pere de misericor¬
Recte iudicate filii hominum.	Recte judicate filii hominum.
Psal.57.	Psal.57.
iour de Nouembre.	jour de Novembre.
