¶ Linstruction des	¶ L’instruction des
enfans/ cõtenant la ma-	enfans/ contenant la ma¬
et escrire en	et escrire en
Loraison de Iesu Christ.	L’oraison de Jesu Christ.
Les articles de la foy.	Les articles de la foy.
La salutation angelicque.	La salutation angelicque.
maniere de recueil/ des seulles sentẽces	maniere de recueil/ des seulles sentences
de lescripture saincte.	de l’escripture saincte.
ualeurs.	valeurs.
Mon peuple a este captif/ pourtant	Mon peuple a este captif/ pourtant
quil na pas eu science.	qu’il n’a pas eu science.
Seigñr/ biẽheureux est lhõme/ lequel	Seigneur/ bienheureux est l’homme/ lequel
a b c d e f g h i k l m n o	a b c d e f g h i k l m n o
p q r s t u x y z	p q r s t u x y z
N O P Q R S T U X Y Z	N O P Q R S T U X Y Z
N O P Q R S T U X	N O P Q R S T U X
¶ Consonantes.	¶ Consonantes.
¶ Aspiration.	¶ Aspiration.
¶ Uoyeles.	¶ Voyeles.
a e i y o u	a e i y o u
i et u	i et u
d d/ i y/ m m/ n n/ r r/ s s/ u u/	d d/ i y/ m m/ n n/ r r/ s s/ u u/
¶ La forme doraison/ laquelle Iesus Christ	¶ La forme d’oraison/ laquelle Jesus Christ
nostre cõmun pere/ pour obtenir toutes cho¬	nostre commun pere/ pour obtenir toutes cho¬
N	N¬
Ostre pere/ qui es eis cieux/	Ostre pere/ qui es eis cieux/
Ton royaume aduienne.	Ton royaume advienne.
re comme au ciel.	re comme au ciel.
Donnè nous au iourdhuy nostre pain	Donnè nous aujourdhuy nostre pain
Et nous pardonnè noz offenses/ ainsi	Et nous pardonnè noz offenses/ ainsi
offensent.	offensent.
Et ne nous induis point en tentation:	Et ne nous induis point en tentation:
¶ Car a toy est le royaume/ ⁊ la puissãce/	¶ Car a toy est le royaume/ et la puissance/
¶ Les articles de nostre foy/ lesquelz deuõs	¶ Les articles de nostre foy/ lesquelz devons
croire de cueur/ ⁊ confesser de bouche.	croire de cueur/ et confesser de bouche.
E croy en Dieu le pere tout puissãt/	E croy en Dieu le pere tout puissant/
Et en Iesus Christ son seul filz/ nostre	Et en Jesus Christ son seul filz/ nostre
seigneur.	seigneur.
uierge Mariè.	vierge Mariè.
crucifie/ mort/ ⁊ enseuely/ descẽdu aux	crucifie/ mort/ et ensevely/ descendu aux
enfers.	enfers.
Monté aux cieux/ seant a la dextre de	Monté aux cieux/ seant a la dextre de
Dont uiẽdra iuger les uifz ⁊ les mortz.	Dont viendra juger les vifz et les mortz.
¶ Ie croy au sainct esperit.	¶ Je croy au sainct esperit.
munion des sainctz/	munion des sainctz/
La resurrection de la chair.	La resurrection de la chair.
La uie eternelle. Amen.	La vie eternelle. Amen.
le seigñr Dieu de mot a mot dõna a Moyse/	le seigneur Dieu de mot a mot donna a Moyse/
strãs ce quil fault faire ⁊ non faire/ desquelz	strans ce qu’il fault faire et non faire/ desquelz
◊ / selon les anciens/ principalle¬	◊ / selon les anciens/ principalle¬
¶ La premiere table contient cinq comman¬	¶ La premiere table contient cinq comman¬
lhõneur de Dieu.	l’honneur de Dieu.
Preface.	Preface.
Oymesme suis l'Eternel/ tõ Di¬	Oymesme suis l’Eternel/ ton Di¬
d'Egypte/ de la maison de seruitude.	d’Egypte/ de la maison de servitude.
¶ Le premier commandement.	¶ Le premier commandement.
uant moy.	vant moy.
Tu ne te feras image taillee/ ne simi¬	Tu ne te feras image taillee/ ne simi¬
litude quelconque/ des choses qui sont	litude quelconque/ des choses qui sont
eis eaues dessoubz la terre. Tu ne t'en	eis eaues dessoubz la terre. Tu ne t’en¬
ras. Car moymesme suis l'Eternel/	ras. Car moymesme suis l’Eternel/
ton Dieu/ Dieu ialoux/ punissãt l'ini¬	ton Dieu/ Dieu jaloux/ punissant l’ini¬
troysiesme ⁊ quatriesme generation/ de	troysiesme et quatriesme generation/ de
ricorde en mille generations/ à ceulx qui	ricorde en mille generations/ à ceulx qui
maymẽt/ ⁊ gardẽt mes cõmandemẽs.	m’ayment/ et gardent mes commandemens.
Tu ne prẽdras point le nom de l'E¬	Tu ne prendras point le nom de l’E¬
ne tiendra point innocent/ celuy qui prẽ	ne tiendra point innocent/ celuy qui pren¬
dra son nom en uain.	dra son nom en vain.
Aye souuenãce du iour du repos poͬ	Aye souvenance du jour du repos pour
feras toute ton oeuure. Mais le septies¬	feras toute ton oeuvre. Mais le septies¬
me iour est le repos de l'Eternel/ ton	me jour est le repos de l’Eternel/ ton
iceluy/ toy/ ton filz/ ta fille/ ton seruiteur/	iceluy/ toy/ ton filz/ ta fille/ ton serviteur/
est dedens tes portes. Car en six iours	est dedens tes portes. Car en six jours
l'Eternel feit le ciel ⁊ la terre/ ⁊ la mer/ ⁊	l’Eternel feit le ciel et la terre/ et la mer/ et
ptiesme iour. Et pourtant l'Eternel be¬	ptiesme jour. Et pourtant l’Eternel be¬
¶ Le .u. commandement.	¶ Le .v. commandement.
Hõnore ton pere ⁊ ta mere/ affin que	Honnore ton pere et ta mere/ affin que
laquelle l'Eternel/ ton Dieu te donne.	laquelle l’Eternel/ ton Dieu te donne.
demens/ cõcernans la dilection du	demens/ concernans la dilection du
prochain/ pour lamour	prochain/ pour l’amour
¶ Le .ui. cõmandement.	¶ Le .ui. commandement.
¶ Le .uii. cõmandement.	¶ Le .uii. commandement.
Tu ne feras point adultere.	Tu ne feras point adultere.
Tu ne desroberas point.	Tu ne desroberas point.
Tu ne diras poĩt faux tesmoigna¬	Tu ne diras point faux tesmoigna¬
ge contre ton prochain.	ge contre ton prochain.
Tu ne conuoiteras point la maison	Tu ne convoiteras point la maison
femme diceluy/ ne son seruiteur/ ne sa	femme d’iceluy/ ne son serviteur/ ne sa
seruante/ ne son beuf/ ne son asne/ ne	servante/ ne son beuf/ ne son asne/ ne
¶ Du mystere de lincarnation de nostre sei¬	¶ Du mystere de l’incarnation de nostre sei¬
fut annõcee a la uierge Marie/ par lãge Ga	fut annoncee a la vierge Marie/ par l’ange Ga¬
briel/ ayant lors mandement de Dieu.	briel/ ayant lors mandement de Dieu.
E	E¬
Ie te salue pleine de grace/ le Sei¬	Je te salue pleine de grace/ le Sei¬
gneur est auec toy/ tu es beneite entre	gneur est avec toy/ tu es beneite entre
elle fut troublee du propos diceluy/ et	elle fut troublee du propos d’iceluy/ et
lange luy dit: Marie ne crains point:	l’ange luy dit: Marie ne crains point:
car tu as trouue grace deuant Dieu.	car tu as trouve grace devant Dieu.
enfãteras un filz/ ⁊ appelleras sõ nom	enfanteras un filz/ et appelleras son nom
neite entre les femmes/ et beneit est le	neite entre les femmes/ et beneit est le
fruict de ton uentre.	fruict de ton ventre.
Elle enfantera un filz/ ⁊ appelleras	Elle enfantera un filz/ et appelleras
ple de leurs pechez.	ple de leurs pechez.
¶ Brieue declaration de loraison	¶ Brieve declaration de l’oraison
escriptures sain¬	escriptures sain¬
Premierement de loraison.	Premierement de l’oraison.
Seigneur/ enseigne nous a prier. Luc.11.a.	Seigneur/ enseigne nous a prier. Luc.11.a.
trouuerez. Frappez (a la porte) ⁊ on uous ouurira.	trouverez. Frappez (a la porte) et on vous ouvrira.
che/ il trouue: ⁊ a celuy qui frappe (a la porte) on	che/ il trouve: et a celuy qui frappe (a la porte) on
luy ouurira. Matth.7.b.	luy ouvrira. Matth.7.b.
pocrites. Car ilz aymẽt debout prier aux assẽblees	pocrites. Car ilz ayment debout prier aux assemblees
hõmes. En uerite ie uous dy/ quilz ont receu leur	hommes. En verite je vous dy/ qu’ilz ont receu leur
loyer. Mais toy/ quãt tu prieras/ entre en ta cham	loyer. Mais toy/ quant tu prieras/ entre en ta cham¬
qui uoyt en secret/ le te rendra manifestement.	qui voyt en secret/ le te rendra manifestement.
cõme les infideles. Car ilz cuidẽt estre exaucez par	comme les infideles. Car ilz cuident estre exaucez par
beaucoup de parolles. Ne soyez donc semblables	beaucoup de parolles. Ne soyez donc semblables
soing: deuãt q̃ le requerez. Uous donc priez ainsi:	soing: devant que le requerez. Vous donc priez ainsi:
Semblablement aussi lesperit ayde noz infir¬	Semblablement aussi l’esperit ayde noz infir¬
mitez. Car nous ne scauons point q̃lle chose nous	mitez. Car nous ne scavons point quelle chose nous
prie pour nous par gemissemens inenarrables. Et	prie pour nous par gemissemens inenarrables. Et
de lesperit. Car il prie pour les sainctz selõ Dieu.	de l’esperit. Car il prie pour les sainctz selon Dieu.
Roma.8.e.	Roma.8.e.
rerez le pere/ ne en ceste mõtaigne/ ne en Hierusalẽ.	rerez le pere/ ne en ceste montaigne/ ne en Hierusalem.
adorateurs adorerõt le pere en esperit ⁊ uerite. Car	adorateurs adoreront le pere en esperit et verite. Car
aussi le pere quiert telz/ qui le adorẽt. Dieu est espe	aussi le pere quiert telz/ qui le adorent. Dieu est espe¬
esperit ⁊ uerite. Iehã.4.c.	esperit et verite. Jehan.4.c.
Dieu en esperit. Philip.3.a.	Dieu en esperit. Philip.3.a.
Ie prieray desperit/ mais ie prieray aussi dentẽ¬	Je prieray d’esperit/ mais je prieray aussi d’enten¬
sens en leglise: affin que ie instruise les autres: que	sens en l’eglise: affin que je instruise les autres: que
Ie uueil donc q̃ les hõmes facẽt oraison en tout	Je vueil donc que les hommes facent oraison en tout
lieu/ leuans les mains pures/ sans ire ⁊ dissentiõ.	lieu/ levans les mains pures/ sans ire et dissention.
Ueillez donc en tout temps/ prians. Luc.21.g.	Veillez donc en tout temps/ prians. Luc.21.g.
temps en esperit. Ephe.6.c.	temps en esperit. Ephe.6.c.
Ie loueray Leternel en tout tẽps/ sa louẽge se¬	Je loueray L’eternel en tout temps/ sa louenge se¬
Nous nous esiouyssõs pour uous deuãt nostre	Nous nous esjouyssons pour vous devant nostre
1.Thessalo.3.c.	1.Thessalo.3.c.
Il faut tousioͬs prier/ ⁊ ne se lasser poĩt. Lu.18.a	Il faut tousjours prier/ et ne se lasser point. Lu.18.a
En uerite/ en uerite ie uous dy/ que se uous de¬	En verite/ en verite je vous dy/ que se vous de¬
le uous donnera. Ioan.16.e.	le vous donnera. Joan.16.e.
¶ Les deux cõditions principallement	¶ Les deux conditions principallement
Marc.11.d.	Marc.11.d.
dez en priant/ croyez que uous laurez: et elles se¬	dez en priant/ croyez que vous l’aurez: et elles se¬
ront uostres.	ront vostres.
nez se uous auez quelque chose cõtre aucun/ affin	nez se vous avez quelque chose contre aucun/ affin
ne uoz pechez.	ne voz pechez.
¶ Nostre pere.	¶ Nostre pere.
toutes choses/ ⁊ nous par luy. 1.Corin.8.a.	toutes choses/ et nous par luy. 1.Corin.8.a.
Ie uous seray pour pere/ ⁊ uoꝰ me serez poͬ filz ⁊	Je vous seray pour pere/ et vous me serez pour filz et
filles/ dit le Seigñr tout puissant. 2.Corin.6.c.	filles/ dit le Seigneur tout puissant. 2.Corin.6.c.
Si dõc ie suis pere: ou est mõ hõneur. Et si ie suis	Si donc je suis pere: ou est mon honneur. Et si je suis
Qui est lhõme dentre uous auquel si son filz	Qui est l’homme d’entre vous auquel si son filz
luy demãde du pain: luy dõnera il une pierre? Ou	luy demande du pain: luy donnera il une pierre? Ou
Se uous donc qui estes mauuais scauez donner a	Se vous donc qui estes mauvais scavez donner a
qui est aux cieux/ donnera des biens a ceux qui le	qui est aux cieux/ donnera des biens a ceux qui le
requierent? Matth.7.b.	requierent? Matth.7.b.
ton nom est a perpetuite. Isaie.63.d.	ton nom est a perpetuite. Isaie.63.d.
graces que tu as absconse ces choses aux sages ⁊	graces que tu as absconse ces choses aux sages et
prudens: ⁊ les as reuele aux petis. Certe pere/ tel a	prudens: et les as revele aux petis. Certe pere/ tel a
sont baillees par mon pere. Et nul na congneu le	sont baillees par mon pere. Et nul n’a congneu le
sinon le filz/ ⁊ celuy auquel le filz le uouldra re¬	sinon le filz/ et celuy auquel le filz le vouldra re¬
ueler. Matth.11.d.	veler. Matth.11.d.
nous soyons nõmez enfans de Dieu. 1.Ioan.3.a.	nous soyons nommez enfans de Dieu. 1.Joan.3.a.
lesperit de son filz en noz coeurs/ criant/ abba (cest	l’esperit de son filz en noz coeurs/ criant/ abba (c’est
a dire) pere. Et par ainsi/ maintenãt nul nest serf/	adire) pere. Et par ainsi/ maintenant nul n’est serf/
Christ. Gala.4.a.	Christ. Gala.4.a.
iceux sont filz de Dieu. Car uous nauez point re¬	iceux sont filz de Dieu. Car vous n’avez point re¬
ceu lesperit de seruitude poͬ estre encore en crainte:	ceu l’esperit de servitude pour estre encore en crainte:
nous crions. abba/ pere. Iceluy esperit rẽd tesmoi¬	nous crions. abba/ pere. Iceluy esperit rend tesmoi¬
de Dieu. Et se nous sommes enfans/ nous sõmes	de Dieu. Et se nous sommes enfans/ nous sommes
aussi heritiers/ heritiers certes de Dieu/ ⁊ coheri¬	aussi heritiers/ heritiers certes de Dieu/ et coheri¬
Nauons nous pas tous un seul pere? nauons	N’avons nous pas tous un seul pere? n’avons
quoy donc un chascun mesprise il son frere/ rõpãt	quoy donc un chascun mesprise il son frere/ rompant
laliance de noz peres? Malach.2.b.	l’aliance de noz peres? Malach.2.b.
qui ta faict ⁊ forme? 5.Moyse.32.a.	qui t’a faict et forme? 5.Moyse.32.a.
Ne uueillez point estre appellez maistres. Car	Ne vueillez point estre appellez maistres. Car
un est ur̃e maistre/ cest ascauoir Christ: mais uous	un est vostre maistre/ c’est ascavoir Christ: mais vous
pere. Car un est ur̃e pere/ qͥ est eis cieux. Mat.23.a.	pere. Car un est vostre pere/ qui est eis cieux. Mat.23.a.
Psal.123.a.	Psal.123.a.
Leternel a constitue son thronne au ciel/ ⁊ son	L’eternel a constitue son thronne au ciel/ et son
Nostre Dieu est au ciel/ il faict toutes choses	Nostre Dieu est au ciel/ il faict toutes choses
Le ciel uniuersel est a Leternel/ ⁊ aux hõmes a	Le ciel universel est a L’eternel/ et aux hommes a
dõne la terre. Ps̈.115.d.	donne la terre. Ps̈.115.d.
de mes piedz. Quelle sera ceste maison que uoꝰ me	de mes piedz. Quelle sera ceste maison que vous me
main a faict toutes ces choses/ ⁊ toutes ces choses	main a faict toutes ces choses/ et toutes ces choses
uniuerselles ont este faictes/ dit Leternel. Isa.66.a.	universelles ont este faictes/ dit L’eternel. Isa.66.a.
Ieremie.23.e.	Jeremie.23.e.
prendre? or que sera il de ceste maison que iay edi¬	prendre? or que sera il de ceste maison que j’ay edi¬
fiee? 1.des Roys.8.d/ 2.des Cronicques.2.b. ⁊. 6.c.	fiee? 1.des Roys.8.d/ 2.des Cronicques.2.b. et. 6.c.
le treshaut ne habite point aux temples faictz de	le tres haut ne habite point aux temples faictz de
Dieu qui a faict le monde/ ⁊ toutes choses qui	Dieu qui a faict le monde/ et toutes choses qui
sont en iceluy/ ueu quil est seigneur du ciel ⁊ de la	sont en iceluy/ veu qu’il est seigneur du ciel et de la
main/ ⁊ si nest point seruy de par les mains des hõ	main/ et si n’est point servy de par les mains des hom¬
celuy qui dõne a tous uie ⁊ respiration par tout/ ⁊	celuy qui donne a tous vie et respiration par tout/ et
a faict de un sang tout le genre humain/ pour ha-	a faict de un sang tout le genre humain/ pour ha¬
ordonnez a ce/ ⁊ les fins de leur habitation/ pour	ordonnez a ce/ et les fins de leur habitation/ pour
ueroiẽt: ia soit quil ne soit point loing de un cha¬	veroient: ja soit qu’il ne soit point loing de un cha¬
scun de nous. Car par luy noꝰ uiuõs ⁊ mouuõs/ ⁊	scun de nous. Car par luy nous vivons et mouvons/ et
Aussi certes nous sõmes genre de luy ⁊c. Act̃.17.f.	Aussi certes nous sommes genre de luy etc. Act̃.17.f.
Ie dõneray a cõgnoistre mõ sainct nom/ au mi-	Je donneray a congnoistre mon sainct nom/ au mi¬
lieu de mon peuple Disrael: ⁊ ne souilleray plus	lieu de mon peuple D’israel: et ne souilleray plus
suis Leternel/ le sainct Disrael. Ezech.39.b.	suis L’eternel/ le sainct D’israel. Ezech.39.b.
luy sera seul. zacha.14.b.	luy sera seul. zacha.14.b.
O maison Disrael ie ne le feray pas/ pour la-	O maison D’israel je ne le feray pas/ pour l’a¬
Quiconque inuocque mon nom: ⁊ ma gloire/ ie	Quiconque invocque mon nom: et ma gloire/ je
Et aduiendra que quicõque inuocquera le nom	Et adviendra que quiconque invocquera le nom
de Leternel sera sauue. Ioel.2.g.	de L’eternel sera sauve. Joel.2.g.
ueilleux par toute la terre uniuerselle. Ps̈.8.a.	veilleux par toute la terre universelle. Ps̈.8.a.
mon nom est grand/ entre les gens ⁊ en toute pla¬	mon nom est grand/ entre les gens et en toute pla¬
ce. Malach.1.c.	ce. Malach.1.c.
Le nom de Leternel est une forte tour: le iuste se	Le nom de L’eternel est une forte tour: le juste se
Uous qui estes seruiteurs de Leternel louez le:	Vous qui estes serviteurs de L’eternel louez le:
louez le nom de Leternel. Le nom de Leternel	louez le nom de L’eternel. Le nom de L’eternel
leil leuant iusques a soleil couchãt: le nom de Le	leil levant jusques a soleil couchant: le nom de L’e¬
Chãtez a Leternel/ ⁊ dõnez louenge a son nom:	Chantez a L’eternel/ et donnez louenge a son nom:
annoncez de iour en iour son salut. Racontez sa	annoncez de jour en jour son salut. Racontez sa
les peuples. Ps̈.96.a.	les peuples. Ps̈.96.a.
mais a ton nom dõne la gloire/ a cause de ta mise	mais a ton nom donne la gloire/ a cause de ta mise¬
ricorde ⁊ de ta uerite. Ps̈.115.a.	ricorde et de ta verite. Ps̈.115.a.
lhonneur de ton nom: ⁊ nous deliure/ ⁊ pardonne	l’honneur de ton nom: et nous delivre/ et pardonne
O Eternel/ enseigne moy ta uoye: ie chemine¬	O Eternel/ enseigne moy ta voye: je chemine¬
ray en ta uerite: unis mõ coeur/ affin quil craigne	ray en ta verite: unis mon coeur/ affin qu’il craigne
louenge de tout mon coeur/ ⁊ glorifieray ton nom	louenge de tout mon coeur/ et glorifieray ton nom
Ie te feray sacrifice en liberalite: o Eternel/ ie	Je te feray sacrifice en liberalite: o Eternel/ je
magnifieray ton nom: car il est bon. Ps̈.54.b.	magnifieray ton nom: car il est bon. Ps̈.54.b.
au milieu de la cõgregation. Ps̈.22.e.33.c. Heb.2.c.	au milieu de la congregation. Ps̈.22.e.33.c. Heb.2.c.
Leternel soit loue. Iob.1.d.	L’eternel soit loue. Job.1.d.
Offrons donc par luy sacrifice de louẽge tous¬	Offrons donc par luy sacrifice de louenge tous¬
sans louenge a son nom. Heb.13.c.	sans louenge a son nom. Heb.13.c.
Cerchez premierement le royaume de dieu/ et sa	Cerchez premierement le royaume de dieu/ et sa
iustice: et toutes choses uous seront adioustees.	justice: et toutes choses vous seront adjoustees.
Le royaume de dieu nest point uiãde ⁊ breuuage:	Le royaume de dieu n’est point viande et breuvage:
Le royaume de dieu nest point en parolle: mais	Le royaume de dieu n’est point en parolle: mais
en uertu. 1.Corin.4.d.	en vertu. 1.Corin.4.d.
dre garde: ⁊ ne diront point: Uoyci/ il est cy: ou il	dre garde: et ne diront point: Voyci/ il est cy: ou il
uous. Luc.17.e.	vous. Luc.17.e.
Se aucun nest nay denhaut: il ne peut ueoir le	Se aucun n’est nay d’enhaut: il ne peut veoir le
Se aucun nest nay de eaue/ ⁊ du sainct esperit:	Se aucun n’est nay de eaue/ et du sainct esperit:
Quicõque ne receuera le royaume de dieu cõme	Quiconque ne recevera le royaume de dieu comme
enfãt: il nẽtrera poĩt en iceluy. Lu.18.c. Mar.10.b.	enfant: il n’entrera point en iceluy. Lu.18.c. Mar.10.b.
du royaume de Dieu. 1.Corin.15.f.	du royaume de Dieu. 1.Corin.15.f.
lent le rauissent. Matth.11.b.	lent le ravissent. Matth.11.b.
Lequel (cest ascauoir Dieu) nous a deliure de	Lequel (c’est ascavoir Dieu) nous a delivre de
royaume de son filz bien ayme: par lequel nous	royaume de son filz bien ayme: par lequel nous
chez ⁊c. Coloss.1.b.	chez etc. Coloss.1.b.
Lors sera incontinent la fin/ quand il baillera	Lors sera incontinent la fin/ quand il baillera
principaute/ ⁊ toute puissance ⁊ uertu. Car il faut	principaute/ et toute puissance et vertu. Car il faut
mis soubz ses piedz. Le dernier ennemy (qui est la	mis soubz ses piedz. Le dernier ennemy (qui est la
mort) sera destruict. 1.Corin.15.d.	mort) sera destruict. 1.Corin.15.d.
13.a.e. Marc.4.a.b. Luc.8.a.b. Matth.13.e.	13.a.e. Marc.4.a.b. Luc.8.a.b. Matth.13.e.
22.a. Luc.14.d. Mat.25.a.b. Luc.19.b.15.a.	22.a. Luc.14.d. Mat.25.a.b. Luc.19.b.15.a.
Ta uolunte soit faicte ⁊c.	Ta volunte soit faicte etc.
Enseigne moy que ie face ta uolunte: car tu es	Enseigne moy que je face ta volunte: car tu es
droicte. Ps̈.143.c.	droicte. Ps̈.143.c.
Ceste est la uolũte de celuy qui ma enuoye/ que	Ceste est la volunte de celuy qui m’a envoye/ que
nelle: ⁊ ie le ressusciteray au dernier iour. Ieh.6.d.	nelle: et je le ressusciteray au dernier jour. Jeh.6.d.
de Leternel: affin quil te soit bien. 5.Moyse.6.c.	de L’eternel: affin qu’il te soit bien. 5.Moyse.6.c.
Uoꝰ ne ferez point ce quil semblera a ung cha¬	Vous ne ferez point ce qu’il semblera a ung cha¬
Plusieurs pẽsees sont au coeur de lhõme: mais	Plusieurs pensees sont au coeur de l’homme: mais
Mon conseil sera ferme/ ⁊ feray toute ma uo¬	Mon conseil sera ferme/ et feray toute ma vo¬
lunte. Isaie.46.d.	lunte. Isaie.46.d.
stes/ que eis habitans de la terre. Et si ny a nul qͥ	stes/ que eis habitans de la terre. Et si ny a nul qui
ce? Daniel.4.g.	ce? Daniel.4.g.
Ce nest point dõc ne par celuy qui ueut/ ne par	Ce n’est point donc ne par celuy qui veut/ ne par
corde. Roma.9.c.	corde. Roma.9.c.
⁊ le faire/ par bonne uolunte. Philip2.b.	et le faire/ par bonne volunte. Philip2.b.
Il oeuure toutes choses selon le cõseil de sa uo	Il oeuvre toutes choses selon le conseil de sa vo¬
Ephesi.1.b.	Ephesi.1.b.
pas que nous soyons suffisans de penser quelque	pas que nous soyons suffisans de penser quelque
chose de nous/ cõme de nous: mais nostre suffisan	chose de nous/ comme de nous: mais nostre suffisan¬
Ie ne fais pas ce que ie ueux: mais ie fay ce que	Je ne fais pas ce que je veux: mais je fay ce que
consentz a la loy quelle est bonne. Item. Ie ne	consentz a la loy qu’elle est bonne. Item. Je ne
fay point le bien/ leq̃l ie ueux: mais ie fais le mal/	fay point le bien/ lequel je veux: mais je fais le mal/
loy/ a moy uueillant faire bien/ que mal mest ad¬	loy/ a moy vueillant faire bien/ que mal m’est ad¬
lhõme interieur: mais ie uoy une autre loy en mes	l’homme interieur: mais je voy une autre loy en mes
mẽbres/ repugnante a la loy de mon entẽdemẽt/ ⁊	membres/ repugnante a la loy de mon entendement/ et
en mes mẽbres. Las moy miserable hõme/ qui me	en mes membres. Las moy miserable homme/ qui me
Dieu/ par Iesus Christ nostre seigneur. Rom̃.7.d.	Dieu/ par Jesus Christ nostre seigneur. Rom̃.7.d.
Qui faict la uolunte de dieu/ demeure eternel¬	Qui faict la volunte de dieu/ demeure eternel¬
Collaudez Leternel uous anges diceluy/ qui	Collaudez L’eternel vous anges d’iceluy/ qui
mẽt/ pour obeir a la uoix de sa parolle. Louez Le	ment/ pour obeir a la voix de sa parolle. Louez L’e¬
ternel uous tous exercites diceluy: qui estes ses mi	ternel vous tous exercites d’iceluy: qui estes ses mi¬
Gloire soit a Dieu eis lieux treshautz: et en	Gloire soit a Dieu eis lieux tres hautz: et en
La uolunte du Seigneur soit faicte. Act̃.21.c.	La volunte du Seigneur soit faicte. Act̃.21.c.
Qui dis a Cyrus mon pasteur/ ⁊ accompliras	Qui dis a Cyrus mon pasteur/ et accompliras
Ie suis descẽdu du ciel: nõ point poͬ faire ma uo	Je suis descendu du ciel: non point pour faire ma vo¬
Tu ne ueux point sacrifice ne offrãde: mais tu	Tu ne veux point sacrifice ne offrande: mais tu
me appareille les aureilles: tu ne demãde point sa¬	me appareille les aureilles: tu ne demande point sa¬
dit: Me uoyci uenu: au roulle du liure il est escrit	dit: Me voyci venu: au roulle du livre il est escrit
bien uoulu: aussi est ta loy dedens mes entrailles.	bien voulu: aussi est ta loy dedens mes entrailles.
Ps̈.49.b. Hebr.10.b.	Ps̈.49.b. Hebr.10.b.
te du pere qui ma enuoye. Ieh.5.e.	te du pere qui m’a envoye. Jeh.5.e.
Matth.26d. Mar.14.d.	Matth.26d. Mar.14.d.
Non point ma uolunte: mais la tienne soit fai-	Non point ma volunte: mais la tienne soit fai¬
Puis dõc que Christ a souffert pour nous en la	Puis donc que Christ a souffert pour nous en la
see. Car qui souffroit en la chair/ a faict fin a pe¬	see. Car qui souffroit en la chair/ a faict fin a pe¬
che: affin que doresnauant de ce quil reste de tẽps	che: affin que doresnavant de ce qu’il reste de temps
mes/ mais a la uolunte de Dieu. 1.Pet̃.4.a.g.	mes/ mais a la volunte de Dieu. 1.Pet̃.4.a.g.
reformez/ en la nouuellete de uostre sens: affin que	reformez/ en la nouvellete de vostre sens: affin que
uous cõgnoissiez par experience/ quelle est la uo-	vous congnoissiez par experience/ quelle est la vo¬
Romains.12.a.	Romains.12.a.
tion/ que uous uous absteniez de fornication: a ce	tion/ que vous vous absteniez de fornication: a ce
que un chascun de uous sache posseder son uais-	que un chascun de vous sache posseder son vais¬
sion de desir/ ainsi cõme les gens/ lesquelles non	sion de desir/ ainsi comme les gens/ lesquelles n’on
Ne soyez point mal aduisez: mais entendans	Ne soyez point mal advisez: mais entendans
quelle est la uolunte de dieu. Ephe.5.d.	quelle est la volunte de dieu. Ephe.5.d.
en prieres/ affin que soyez parfaictz et consommez	en prieres/ affin que soyez parfaictz et consommez
Et ceste est la fiance/ laquelle auõs a luy/ que ce	Et ceste est la fiance/ laquelle avons a luy/ que ce
que nous demanderons selon sa uolunte il nous	que nous demanderons selon sa volunte il nous
Et le dieu de paix qui a retire des mortz le grãd	Et le dieu de paix qui a retire des mortz le grand
le sang du testament eternel/ uous rende parfaictz	le sang du testament eternel/ vous rende parfaictz
en toute bonne oeuure/ pour faire sa uolunte/ ⁊ fa	en toute bonne oeuvre/ pour faire sa volunte/ et fa¬
Christ/ auq̃l est gloire eis siecles des siecles. Amẽ.	Christ/ auquel est gloire eis siecles des siecles. Amen.
Dõne nous auiourdhuy ⁊c.	Donne nous aujourdhuy etc.
La benediction de Leternel enrichy/ ⁊ ce sans	La benediction de L’eternel enrichy/ et ce sans
Il donne uiande a toute creature: car sa miseri¬	Il donne viande a toute creature: car sa miseri¬
Aussi a tout hõme a qui dieu a dõne richesse et	Aussi a tout homme a qui dieu a donne richesse et
cheuance/ ⁊ luy a dõne faculte den menger ⁊ pren¬	chevance/ et luy a donne faculte d’en menger et pren¬
dieu. Eccłs.5.d.	dieu. Eccłs.5.d.
famine. Prouer.10.a.	famine. Prover.10.a.
Iay este ieune enfãt/ ⁊ si suys enuieilly/ mais ie	J’ay este jeune enfant/ et si suys envieilly/ mais je
le pain. Ps̈.37.d.	le pain. Ps̈.37.d.
leurs petis crient enuers Dieu: lesq̃lz sont errans	leurs petis crient envers Dieu: lesquelz sont errans
par faute de mengeaille? Iob.38.c.	par faute de mengeaille? Job.38.c.
corbeaux/ qui crient. Ps̈.147.b.	corbeaux/ qui crient. Ps̈.147.b.
⁊ a enquerir de dieu uiande pour eux. Ps.104.c.	et a enquerir de dieu viande pour eux. Ps.104.c.
Tous iceux sont attendans apres toy/ que tu	Tous iceux sont attendans apres toy/ que tu
⁊ la recueillẽt: tu ouure ta main/ lors sont rassasiez	et la recueillent: tu ouvre ta main/ lors sont rassasiez
Remetz ta cure a Leternel/ et il te nourrira.	Remetz ta cure a L’eternel/ et il te nourrira.
Ps̈.55.d.	Ps̈.55.d.
uous. 1.Pier.5.b.	vous. 1.Pier.5.b.
re ⁊ oraison auec actiõ de graces uoz petitiõs soiẽt	re et oraison avec action de graces voz petitions soient
notoires uers dieu. Philip.4.a.	notoires vers dieu. Philip.4.a.
uostre uie/ q̃ uous mãgerez ou beuurez: ne pour uo	vostre vie/ que vous mangerez ou beuvrez: ne pour vo¬
uie/ que la uiande: ⁊ le corps plus que le uestemẽt?	vie/ que la viande: et le corps plus que le vestement?
Regardez aux oyseaux du ciel. Car ilz ne semẽt/	Regardez aux oyseaux du ciel. Car ilz ne sement/
uostre pere celeste les nourrit. Nestes uous point	vostre pere celeste les nourrit. N’estes vous point
luy de uous qui en se souciãt puisse adiouster a sa	luy de vous qui en se souciant puisse adjouster a sa
grandeur une coudee? Et pourquoy estes uous en	grandeur une coudee? Et pourquoy estes vous en
cõmẽt ilz croissent. Ilz ne labeurẽt/ ⁊ ne fillẽt poĩt.	comment ilz croissent. Ilz ne labeurent/ et ne fillent point.
gloire/ na point este uestu/ cõme un diceux. Se dieu	gloire/ n’a point este vestu/ comme un d’iceux. Se dieu
donc uest ainsi lherbe des champs/ laquelle est au¬	donc vest ainsi l’herbe des champs/ laquelle est au¬
plus le fera il a uous/ o gens de petite fiance? Ne	plus le fera il a vous/ o gens de petite fiance? Ne
⁊ que beuurõs nous? ou dequoy serõs noꝰ uestus?	et que beuvrons nous? ou dequoy serons nous vestus?
Car les gens senquierẽt de toutes ces choses. Cer¬	Car les gens s’enquierent de toutes ces choses. Cer¬
ces choses auez besoing. Querez dõc premieremẽt	ces choses avez besoing. Querez donc premierement
Ne me dõne mendicite/ ne richesses: dõne moy a	Ne me donne mendicite/ ne richesses: donne moy a
uiure par mesure: q̃ par auẽture quãd seroye saou¬	vivre par mesure: que par aventure quand seroye saou¬
par indigence ie ne desrobe: ⁊ que ne prenne en uain	par indigence je ne desrobe: et que ne prenne en vain
Si les richesses abondent/ ny mettez point le	Si les richesses abondent/ n’y mettez point le
coeur. Ps̈.62.c.	coeur. Ps̈.62.c.
Moymesme moymesme suis celuy qui efface	Moymesme moymesme suis celuy qui efface
souuenance de tes pechez. Isaie.43.d.	souvenance de tes pechez. Isaie.43.d.
Iay efface ton iniquite cõme la nuee/ ⁊ tõ peche	J’ay efface ton iniquite comme la nuee/ et ton peche
ranty. Isa.44.d.	ranty. Isa.44.d.
tient ⁊ moult debonnaire: il ne estriue iamais/ ⁊ ne	tient et moult debonnaire: il ne estrive jamais/ et ne
garde point son courroux eternellemẽt. Il ne noꝰ	garde point son courroux eternellement. Il ne nous
selon noz iniquitez. Car selon la hauteur du ciel	selon noz iniquitez. Car selon la hauteur du ciel
ceux qui le craignẽt. Selon la longueur de Oriẽt	ceux qui le craignent. Selon la longueur de Orient
en Occident: de tant faict il noz transgressions	en Occident: de tant faict il noz transgressions
ses enfãs: ainsi Leternel a misericorde de ceux qui	ses enfans: ainsi L’eternel a misericorde de ceux qui
me/ ⁊ a recordation q̃ noꝰ sõmes poudre. Ps̈.103.b.	me/ et a recordation que nous sommes poudre. Ps̈.103.b.
Ne soys point hõteux de ꝯfesser tes pechez: ⁊ ne	Ne soys point honteux de confesser tes pechez: et ne
Si nous cõfessons noz pechez/ dieu est fidele et	Si nous confessons noz pechez/ dieu est fidele et
toyer de toute iniquite. Si nous disons que nauõs	toyer de toute iniquite. Si nous disons que n’avons
point peche: nous le faisons menteur/ ⁊ sa parolle	point peche: nous le faisons menteur/ et sa parolle
Qui dira: mon cueur est purge? ie suis net de	Qui dira: mon cueur est purge? je suis net de
Car il nest hõme iuste en la terre/ qͥ face bien/ ⁊	Car il n’est homme juste en la terre/ qui face bien/ et
ne peche. Eccl.7.c. 1.Roys.8.e. Ps̈.53.a. Ro.3.b.	ne peche. Eccl.7.c. 1.Roys.8.e. Ps̈.53.a. Ro.3.b.
Qui est lhõme sans macule/ ⁊ iuste/ estant nay	Qui est l’homme sans macule/ et juste/ estant nay
si les cieux ne sont point netz deuant ses yeux. Cõ	si les cieux ne sont point netz devant ses yeux. Com¬
bien plus sera lhõme abominable ⁊ inutile/ qͥ boit	bien plus sera l’homme abominable et inutile/ qui boit
Qui est celuy qui entend les pechez? Seigneur	Qui est celuy qui entend les pechez? Seigneur
Iay tourne ma face uers mon Seigneur dieu:	J’ay tourne ma face vers mon Seigneur dieu:
pour prier ⁊ faire supplication/ en ieunes/ en sac/ ⁊	pour prier et faire supplication/ en jeunes/ en sac/ et
⁊ dis: Ie te prie Seigneur dieu/ qui es grand ⁊ ter¬	et dis: Je te prie Seigneur dieu/ qui es grand et ter¬
Ie tay manifeste mon peche/ ⁊ nay point cache	Je t’ay manifeste mon peche/ et n’ay point cache
mon delict/ Iay dict: Me accusant moymesme/ ie	mon delict/ J’ay dict: Me accusant moymesme/ je
pardonne loffence de mon peche. Ps̈.32.a. ⁊. 19.d.	pardonne l’offence de mon peche. Ps̈.32.a. et. 19.d.
de: efface ma trãsgression selon la multitude de ta	de: efface ma transgression selon la multitude de ta
benignite. Laue moy tresgrandement de mon ini¬	benignite. Lave moy tres grandement de mon ini¬
ma transgression/ ⁊ mon peche estre tousiours con	ma transgression/ et mon peche estre tousjours con¬
deuant tes yeux. Ps̈.51.a.	devant tes yeux. Ps̈.51.a.
Conuertis moy/ ⁊ ie seray conuerty. Car tu es	Convertis moy/ et je seray converty. Car tu es
Purifie moy de ysope/ ⁊ ie seray nettoye: laue	Purifie moy de ysope/ et je seray nettoye: lave
Cõme nous pardonnons ⁊c.	Comme nous pardonnons etc.
Si uous pardõnez aux hommes leurs fautes/	Si vous pardonnez aux hommes leurs fautes/
ne remettez aux hõmes leurs offenses: aussi uostre	ne remettez aux hommes leurs offenses: aussi vostre
thieu.6.b. Luc.11.d.	thieu.6.b. Luc.11.d.
Pardonnez/ ⁊ il uous sera pardonne. Luc.6.f.	Pardonnez/ et il vous sera pardonne. Luc.6.f.
que ton frere a quelque chose a lencontre de toy/	que ton frere a quelque chose a l’encontre de toy/
te recõcilier a ton frere. Et alors uiens/ et presente	te reconcilier a ton frere. Et alors viens/ et presente
ton don. Soys bien tost dacord auec tõ aduerse	ton don. Soys bien tost d’acord avec ton adverse
naduiẽne/ que ton aduerse partie te liure au iuge/ ⁊	n’advienne/ que ton adverse partie te livre au juge/ et
uoye en prison. Ie te dis en uerite/ que tu ne parti¬	voye en prison. Je te dis en verite/ que tu ne parti¬
ras de la iusque a ce que tu auras paye la derniere	ras de la jusque a ce que tu auras paye la derniere
Si tõ frere ta offense/ ua ⁊ le reprẽs entre toy ⁊	Si ton frere t’a offense/ va et le reprens entre toy et
leste: si uoꝰ ne auez pardõne de uoz coeurs un cha¬	leste: si vous ne avez pardonne de voz coeurs un cha¬
scun de uous a son frere. Matth.18.c.d. Luc.17.a.	scun de vous a son frere. Matth.18.c.d. Luc.17.a.
pour lautre. Iacques.5.d.	pour l’autre. Jacques.5.d.
mesmes. Si aucũ cõtre aucun a q̃relle: cõme aussi	mesmes. Si aucun contre aucun a querelle: comme aussi
Christ uoꝰ a ꝑdõne/ uoꝰ aussi pareillemẽt. Coł.3.b.	Christ vous a pardonne/ vous aussi pareillement. Coł.3.b.
pour ceux qui uous outragent. Luc.6.d.	pour ceux qui vous outragent. Luc.6.d.
poursuyuẽt: affin que soyez enfans de uostre pere/	poursuyvent: affin que soyez enfans de vostre pere/
qui est eis cieux/ lequel faict leuer son soleil sur	qui est eis cieux/ lequel faict lever son soleil sur
iustes ⁊ iniustes. Matth.5.g.	justes et injustes. Matth.5.g.
uent quilz font. Luc.23.e.	vent qu’ilz font. Luc.23.e.
S. Estiẽne) Seigñr ne leur ĩpute poĩt ce peche:	Sainct Estienne) Seigneur ne leur impute point ce peche:
Et ne nous induis point en tẽtation.	Et ne nous induis point en tentation.
miere qui sensuit est approbation de nr̃e foy.	miere qui s’ensuit est approbation de nostre foy.
Mes freres reputez pour toute ioye/ quãd uous	Mes freres reputez pour toute joye/ quand vous
probation de uostre foy faict auoir patience. Iac¬	probation de vostre foy faict avoir patience. Jac¬
Bienheureux est lhõme qui souffre tentation:	Bienheureux est l’homme qui souffre tentation:
Car quand il aura este esprouue il receura la cou¬	Car quand il aura este esprouve il recevra la cou¬
laymeroient. Iacques.1.b.	l’aymeroient. Jacques.1.b.
nel: ⁊ ne te courrouce pas quãd il te corrigera. Car	nel: et ne te courrouce pas quand il te corrigera. Car
celuy que Leternel ayme/ il le chastie: ⁊ y prẽt son	celuy que L’eternel ayme/ il le chastie: et y prent son
La fournaise esprouue les uaisseaux du potier:	La fournaise esprouve les vaisseaux du potier:
Ecclesiastic.27.a.	Ecclesiastic.27.a.
O Eternel esprouue moy/ ⁊ me tẽte/ brusle mes	O Eternel esprouve moy/ et me tente/ brusle mes
Cest assez que tu aye ma grace: car ma uertu est	C’est assez que tu aye ma grace: car ma vertu est
Dieu est fidele/ lequel ne uous laissera point	Dieu est fidele/ lequel ne vous laissera point
tenter/ outre ce que pouez: mais fera bonne yssue	tenter/ outre ce que povez: mais fera bonne yssue
1.Corin.10.c.	1.Corin.10.c.
2.Pierre.2.b.	2.Pierre.2.b.
Uous estes ceux qui auez perseuere auec moy	Vous estes ceux qui avez persevere avec moy
¶ De lautre tentation/ laquelle	¶ De l’autre tentation/ laquelle
Ueillez ⁊ priez/ affin que uous nentriez en ten¬	Veillez et priez/ affin que vous n’entriez en ten¬
tation. Certes lesperit est prompt/ mais la chair est	tation. Certes l’esperit est prompt/ mais la chair est
Quand aucun est tẽte/ ne die point quil est tẽte	Quand aucun est tente/ ne die point qu’il est tente
aussi ne tente il point aucun: mais un chascun est	aussi ne tente il point aucun: mais un chascun est
tente/ quand par sa propre concupiscence est attire	tente/ quand par sa propre concupiscence est attire
ceu elle enfante peche: ⁊ le peche quand il est con¬	ceu elle enfante peche: et le peche quand il est con¬
Ceux qui appetent estre riches/ ilz tombent en	Ceux qui appetent estre riches/ ilz tombent en
tẽtation/ ⁊ au lacz ⁊ plusieurs desirs. 1.Timo.6.c.	tentation/ et au lacz et plusieurs desirs. 1.Timo.6.c.
tente. Gala.6.a.	tente. Gala.6.a.
maling.	maling.
Soyez sobres/ et ueillez: Car uostre aduersaire	Soyez sobres/ et veillez: Car vostre adversaire
quelcun poͬ deuorer/ auq̃l resistez fort en la foy ⁊c.	quelcun pour devorer/ auquel resistez fort en la foy etc.
Ie ne prie point que tu les ostes du mondeimais	Je ne prie point que tu les ostes du monde mais
que tu les garde du mauuais. Iehan.17.c.	que tu les garde du mauvais. Jehan.17.c.
me le froment/ mais iay prie pour toy/ affin que ta	me le froment/ mais j’ay prie pour toy/ affin que ta
conferme tes freres. Luc.22.c.	conferme tes freres. Luc.22.c.
Iay enuoye pour congnoistre uostre foy: affin q̃	J’ay envoye pour congnoistre vostre foy: affin que
nostre labeur ne soit uain. 1.Thess.3.b.	nostre labeur ne soit vain. 1.Thess.3.b.
peche poĩt: mais qͥ est nay de Dieu/ il se garde soy¬	peche point: mais qui est nay de Dieu/ il se garde soy¬
mesme/ ⁊ le mauuais ne le touche point. 1.Ieh.5.d.	mesme/ et le mauvais ne le touche point. 1.Jeh.5.d.
de: et ceste est la uictoire/ qui surmonte le monde/	de: et ceste est la victoire/ qui surmonte le monde/
¶ Car a toy est le royaume ⁊c.	¶ Car a toy est le royaume etc.
O Eternel/ dieu Disrael nostre pere/ loue soye	O Eternel/ dieu D’israel nostre pere/ loue soye
toy est la magnificence/ ⁊ la puissance/ ⁊ la gloire/	toy est la magnificence/ et la puissance/ et la gloire/
⁊ en la terre est tien. O Eternel a toy est le royau¬	et en la terre est tien. O Eternel a toy est le royau¬
me/ ⁊ as la principaute sur tous princes. A toy sõt	me/ et as la principaute sur tous princes. A toy sont
tout/ ⁊ en ta main est la uertu ⁊ puissance/ et en ta	tout/ et en ta main est la vertu et puissance/ et en ta
tenant nostre Dieu/ nous te rendons louenge/ et	tenant nostre Dieu/ nous te rendons louenge/ et
collaudõs ton noble nom. 1.Cronic.29.c. Uoyez	collaudons ton noble nom. 1.Cronic.29.c. Voyez
A dieu seul saige/ nostre sauueur/ gloire et ma¬	A dieu seul saige/ nostre sauveur/ gloire et ma¬
les siecles. Amen. Iude.1.g. Rom̃.11.d.16.d. Timo.	les siecles. Amen. Jude.1.g. Rom̃.11.d.16.d. Timo.
1.d. 1.Pet̃.5.d. Apoca.5.d.7.c.	1.d. 1.Pet̃.5.d. Apoca.5.d.7.c.
lhonneur/ ⁊ la puissance. Car tu as cree toutes cho	l’honneur/ et la puissance. Car tu as cree toutes cho¬
Apocalip.4.d.	Apocalip.4.d.
¶ Declaration des articles	¶ Declaration des articles
¶ Ie croy.	¶ Je croy.
⁊ certification des choses non apparẽtes. Heb.11.a.	et certification des choses non apparentes. Heb.11.a.
Il faut que celuy qui uiẽt a Dieu/ croye quil	Il faut que celuy qui vient a Dieu/ croye qu’il
rent. Heb.11.a.	rent. Heb.11.a.
dit chapitre .a.	dit chapitre .a.
Tout ce qui nest point faict en foy/ est peche.	Tout ce qui n’est point faict en foy/ est peche.
Cecy est loeuure de dieu/ que uous croyez en ce¬	Cecy est l’oeuvre de dieu/ que vous croyez en ce¬
Le don esleu de foy luy sera dõne: ⁊ le sort tresa¬	Le don esleu de foy luy sera donne: et le sort tres a¬
greable au temple de Dieu. Sapiẽce.3.c.	greable au temple de Dieu. Sapiẽce.3.c.
Seigneur. Osee.2.d.	Seigneur. Osee.2.d.
En uerite/ en uerite ie uous dy que qui oyt ma	En verite/ en verite je vous dy que qui oyt ma
parolle/ ⁊ croit a celuy qui ma enuoye/ il a uie eter	parolle/ et croit a celuy qui m’a envoye/ il a vie eter¬
sera de la mort en la uie. Iehã.5.d.	sera de la mort en la vie. Jehã.5.d.
plent toute la terre/ et donnent force a ceux qui de	plent toute la terre/ et donnent force a ceux qui de
coeur par faict croyent en luy. 2.Cronicques.16.c.	coeur parfaict croyent en luy. 2.Cronicques.16.c.
cestuy qui iustifie linfidele. Romains.4.a.	cestuy qui justifie l’infidele. Romains.4.a.
quelle est en Iesu Christ. Gał.3.d.	quelle est en Jesu Christ. Gał.3.d.
Dieu qui congnoit les coeurs leur a baille tes¬	Dieu qui congnoit les coeurs leur a baille tes¬
a nous/ ⁊ na point faict de difference entre nous et	a nous/ et n’a point faict de difference entre nous et
Uous estes sauuez de grace par la foy/ ⁊ ce nest	Vous estes sauvez de grace par la foy/ et ce n’est
point de uous/ cest don de Dieu/ non point par les	point de vous/ c’est don de Dieu/ non point par les
mes son oeuure/ crees a Iesus Christ a bõnes oeu¬	mes son oeuvre/ crees a Jesus Christ a bonnes oeu¬
nions en icelles. Ephes.2.b.	nions en icelles. Ephes.2.b.
Nous scauons que lhõme nest point iustifie par	Nous scavons que l’homme n’est point justifie par
Christ/ ⁊ nous auons creu en Iesus Christ/ affin q̃	Christ/ et nous avons creu en Jesus Christ/ affin que
par les oeuures de la loy: pourtãt que toute chair	par les oeuvres de la loy: pourtant que toute chair
nest poĩt iustifiee ꝑ les oeuures de la loy. Gał.2.d.	n’est point justifiee par les oeuvres de la loy. Gał.2.d.
grace la ꝓmesse soit ferme a toute semẽce. Ro.4.c.	grace la promesse soit ferme a toute semence. Ro.4.c.
et a sa semence/ affin quil fut heritier du monde/	et a sa semence/ affin qu’il fut heritier du monde/
mais par la iustice de foy. Rom̃.4.c.	mais par la justice de foy. Rom̃.4.c.
dequoy se glorifier/ mais non point enuers Dieu.	de quoy se glorifier/ mais non point envers Dieu.
Dieu/ ⁊ il luy a este repute a iustice. Rom̃.4.a.	Dieu/ et il luy a este repute a justice. Rom̃.4.a.
En Iesus Christ ne la circoncision/ ne le prepu¬	En Jesus Christ ne la circoncision/ ne le prepu¬
Gala.5.b.	Gala.5.b.
tailloyent/ aussi Dieu les a exauce pource quilz	tailloyent/ aussi Dieu les a exauce pource qu’ilz
ont creu en luy. 1.Cronicques.5.c.	ont creu en luy. 1.Cronicques.5.c.
Abacuc.2.a.	Abacuc.2.a.
a celuy qui croyt. Marc.9.d.	a celuy qui croyt. Marc.9.d.
Ainsi te soit il faict/ cõe tu croys. Mat.8.b.9.d.	Ainsi te soit il faict/ comme tu croys. Mat.8.b.9.d.
On croyt de coeur a iustice/ ⁊ on cõfesse de bou¬	On croyt de coeur a justice/ et on confesse de bou¬
Iay creu/ pour ce iay parle. 2.Cor.4.c.	J’ay creu/ pour ce j’ay parle. 2.Cor.4.c.
Il uous est donne poͬ Christ/ non point de croy	Il vous est donne pour Christ/ non point de croy¬
Philip.1.d.	Philip.1.d.
aornẽt la doctrine de dieu nostre sauueur. Tit.2.b.	aornent la doctrine de dieu nostre sauveur. Tit.2.b.
Uous qui croyez/ uous uous esiouyrez de ioye	Vous qui croyez/ vous vous esjouyrez de joye
foy le salut de uoz ames. 1.Pier.1.b.	foy le salut de voz ames. 1.Pier.1.b.
foy/ sans les oeuures de la loy. Rom̃.3.d.	foy/ sans les oeuvres de la loy. Rom̃.3.d.
Uoyez plusieurs exẽples de la foy) Hebr.11.	Voyez plusieurs exemples de la foy) Hebr.11.
Tu croys que il est un Dieu: tu fays bien. Et	Tu croys que il est un Dieu: tu fays bien. Et
La foy sans oeuures est morte. Au dit chap̃.	La foy sans oeuvres est morte. Au dit chapitre.
Ilz cõfessent Dieu de bouche/ mais de faictz ilz	Ilz confessent Dieu de bouche/ mais de faictz ilz
Qui dit que il congnoit dieu/ ⁊ ne garde point	Qui dit que il congnoit dieu/ et ne garde point
en luy: ⁊ qui garde sa parolle la charite de dieu est	en luy: et qui garde sa parolle la charite de dieu est
urayement parfaicte en ce. Nous scauons par ce:	vrayement parfaicte en ce. Nous scavons par ce:
en Christ/ il doit aussi cheminer cõme iceluy a che	en Christ/ il doit aussi cheminer comme iceluy a che¬
Si iay prophetie/ ⁊ que ie cõgnoisse les myste-	Si j’ay prophetie/ et que je congnoisse les myste¬
res/ ⁊ toute science/ ⁊ que iaye toute la foy/ tellemẽt	res/ et toute science/ et que j’aye toute la foy/ tellement
nay charite/ ie ne suis rien. 1.Corin.13.a.	n’ay charite/ je ne suis rien. 1.Corin.13.a.
de bõne consciẽce/ ⁊ de foy non feinte. 1.Timo.1.a.	de bonne conscience/ et de foy non feinte. 1.Timo.1.a.
2.Timo.1.a.	2.Timo.1.a.
Il est un Seigneur/ une foy/ un baptesme/ un	Il est un Seigneur/ une foy/ un baptesme/ un
en nous tous. Ephe.4.a.	en nous tous. Ephe.4.a.
Il est un Dieu/ ⁊ un moyenneur de Dieu ⁊ des	Il est un Dieu/ et un moyenneur de Dieu et des
Maintenant Seigñr/ tu es nostre pere/ ⁊ nous	Maintenant Seigneur/ tu es nostre pere/ et nous
noꝰ tous sõmes les oeuures de tes mains. Isa.64.c.	nous tous sommes les oeuvres de tes mains. Isa.64.c.
tout puissant.	tout puissant.
est il quelque chose a moy impossible? Ierem̃.32.e.	est il quelque chose a moy impossible? Jerem̃.32.e.
thieu.19.d. Marc.10.d. Luc.8.e.	thieu.19.d. Marc.10.d. Luc.8.e.
Dieu est puissant de susciter de ces pierres en¬	Dieu est puissant de susciter de ces pierres en¬
Nulle parolle ne sera ĩpossible uers dieu. Luc.1.d.	Nulle parolle ne sera impossible vers dieu. Luc.1.d.
Il ny a que un mesme Dieu/ qui oeuure toutes	Il n’y a que un mesme Dieu/ qui oeuvre toutes
choses en tous. 1.Corin.12.a.	choses en tous. 1.Corin.12.a.
Gene.1.a.	Gene.1.a.
et la terre par ta grande puissance ⁊ par ton bras	et la terre par ta grande puissance et par ton bras
estendu/ rien ne est a toy impossible. Ierem̃.32.c.	estendu/ rien ne est a toy impossible. Jerem̃.32.c.
⁊ toutes choses qui sont en iceux. Act.4.d.	et toutes choses qui sont en iceux. Act.4.d.
Psal.33.b.	Psal.33.b.
Seigneur tu as fonde la terre au cõmencemẽt.	Seigneur tu as fonde la terre au commencement.
Il dõne a tous uie ⁊ respiration/ par tout. Par	Il donne a tous vie et respiration/ par tout. Par
Car de luy/ ⁊ par luy/ ⁊ en luy sont toutes cho¬	Car de luy/ et par luy/ et en luy sont toutes cho¬
ses. Romains.11.d.	ses. Romains.11.d.
Cestuy est son cõmãdemẽt/ que croyõs au nom	Cestuy est son commandement/ que croyons au nom
cõme il nous en a dõne le cõmandemẽt. 1.Ieh.3.d.	comme il nous en a donne le commandement. 1.Jeh.3.d.
Iay appelle mon filz de Egypte. Osee.12.a.	J’ay appelle mon filz de Egypte. Osee.12.a.
Auquel des anges a il oncque dit. Tu es mon	Auquel des anges a il oncque dit. Tu es mon
seray pour pere: ⁊ luy il me sera pour filz. Heb.1.b.	seray pour pere: et luy il me sera pour filz. Heb.1.b.
Ps̈.2.b.2. Samuel.7.b.	Ps̈.2.b.2. Samuel.7.b.
mon bon plaisir: oyez le. Matth.3.d.17.a.	mon bon plaisir: oyez le. Matth.3.d.17.a.
Luc.1.c.	Luc.1.c.
Tu es Christ le filz de dieu uiuãt. Matth.16.c.	Tu es Christ le filz de dieu vivant. Matth.16.c.
Dieu par son filz a parle aux derniers temps a	Dieu par son filz a parle aux derniers temps a
Qui luy a este faict de la semence de Dauid se¬	Qui luy a este faict de la semence de David se¬
lon la chair/ qui est declaire le filz de dieu en puis¬	lon la chair/ qui est declaire le filz de dieu en puis¬
Qui est limage de dieu inuisible/ premier nay	Qui est l’image de dieu invisible/ premier nay
ses crees eis cieux ⁊ en la terre/ uisibles ⁊ inuisi¬	ses crees eis cieux et en la terre/ visibles et invisi¬
bles/ soit les thrones/ soit les dominatiõs/ soit les	bles/ soit les thrones/ soit les dominations/ soit les
luy ⁊ en luy sõt crees: ⁊ il est deuãt toutes choses/	luy et en luy sont crees: et il est devant toutes choses/
Christ/ qui est limage de dieu. 2.Corin4.a.	Christ/ qui est l’image de dieu. 2.Corin.4.a.
Lequel cõme ainsi soit quil soit la splẽdeur de	Lequel comme ainsi soit qu’il soit la splendeur de
Au cõmencement estoit la parolle/ ⁊ la parolle	Au commencement estoit la parolle/ et la parolle
Deuant q̃ Abraham ◊	Devant que Abraham ◊
Uoꝰ croyez en dieu/ croyez aussi en moy. Io.14.a	Vous croyez en dieu/ croyez aussi en moy. Jo.14.a
Moy ⁊ mon pere sommes un. Iehã.10.f.	Moy et mon pere sommes un. Jehã.10.f.
En ce iour la/ uous cõgnoistrez q̃ ie suis en mõ	En ce jour la/ vous congnoistrez que je suis en mon
pere: ⁊ uous en moy/ ⁊ moy en uous. Iehã.14.c.	pere: et vous en moy/ et moy en vous. Jehã.14.c.
uie/ nul ne uient a mon pere/ sinon par moy. Si	vie/ nul ne vient a mon pere/ sinon par moy. Si
cõgneu mon pere. Ieh.14.a	congneu mon pere. Jeh.14.a
Ie suis lhuys. Ieh.10.b.	Je suis l’huys. Jeh.10.b.
tire. Iehã.6.e.	tire. Jehã.6.e.
sa main/ qui croit au filz il a uie eternelle. Et qͥ est	sa main/ qui croit au filz il a vie eternelle. Et qui est
incredule/ il ne uerra poĩt la uie/ mais lire de dieu	incredule/ il ne verra point la vie/ mais l’ire de dieu
Ceste est la uie eternelle/ qͥl te cõgnoissent seul	Ceste est la vie eternelle/ qu’il te congnoissent seul
Qui croyt au filz de Dieu il a tesmoignage en	Qui croyt au filz de Dieu il a tesmoignage en
soymesme. 1.Iehã.5.b.	soymesme. 1.Jehã.5.b.
seul filz: affin que tout hõme qui croyt en luy/ ne	seul filz: affin que tout homme qui croyt en luy/ ne
na point enuoye son filz au monde/ pour iuger le	n’a point envoye son filz au monde/ pour juger le
monde: mais affin q̃ le monde soit sauue par luy.	monde: mais affin que le monde soit sauve par luy.
point/ il est desia iuge: car il ne croyt poit au nom	point/ il est desja juge: car il ne croyt point au nom
Par lequel nous auons fiance ⁊ acces en confi	Par lequel nous avons fiance et acces en confi¬
dence par la foy diceluy. Ephe.4.b.	dence par la foy d’iceluy. Ephe.4.b.
ne aux hões/ auq̃l il noꝰ faille estre sauuez. Act̃.4.b	ne aux hommes/ auquel il nous faille estre sauvez. Act̃.4.b
Uoicy cõme le filz de lhomme qui uenoit aux	Voicy comme le filz de l’homme qui venoit aux
nuees du ciel: Il luy dõna puissance/ ⁊ hõneur/ et	nuees du ciel: Il luy donna puissance/ et honneur/ et
seruirõt. Sa puissance est une puissance eternelle/	serviront. Sa puissance est une puissance eternelle/
aboly. Daniel.7.d.	aboly. Daniel.7.d.
Ilz serõt mõ peuple/ ⁊ ie leur seray Dieu: ⁊ mõ	Ilz seront mon peuple/ et je leur seray Dieu: et mon
steur deux tous. Ezech.37.f.	steur d’eux tous. Ezech.37.f.
roy/ lequel ie leur susciteray. Iere.30.b.	roy/ lequel je leur susciteray. Jere.30.b.
De toy me sortira le gouuerneur en Israel.	De toy me sortira le gouverneur en Israel.
Il regnera sur la maison de Iacob eternelle¬	Il regnera sur la maison de Jacob eternelle¬
Auiourdhuy nous est nay le sauueur/ qui est	Aujourdhuy nous est nay le sauveur/ qui est
Christ/ le seigneur. Luc.2.b.	Christ/ le seigneur. Luc.2.b.
tes choses ⁊ nous par luy. 1.Corin.8.b.	tes choses et nous par luy. 1.Corin.8.b.
Il mest dõne toute puissance au ciel ⁊ en la ter¬	Il m’est donne toute puissance au ciel et en la ter¬
re. Matth.28.d. Marc.16.b.	re. Matth.28.d. Marc.16.b.
na cõgneu le filz/ sinon le pere: ⁊ si nul na cõgneu	n’a congneu le filz/ sinon le pere: et si nul n’a congneu
reueler. Mat.11.d.	reveler. Mat.11.d.
Pere/ lheure est uenue: clarifie ton filz/ affin q̃	Pere/ l’heure est venue: clarifie ton filz/ affin que
sãce sur toute chair. Ieh.17.a. Ieh.13.a.	sance sur toute chair. Jeh.17.a. Jeh.13.a.
sur tout nom: affin que au nom de Iesus/ tout ge-	sur tout nom: affin que au nom de Jesus/ tout ge¬
nouil soit flechy de ceux qui sõt aux cieux et qͥ sõt	nouil soit flechy de ceux qui somt aux cieux et qui sont
nostre Seigñr est Iesus Christ/ a la gloire de dieu	nostre Seigneur est Jesus Christ/ a la gloire de dieu
Il faut q̃ il regne/ iusq̃ a ce quil mette tous ses	Il faut que il regne/ jusque a ce qu’il mette tous ses
ennemys soubz ses piedz. Et au dernier la mort en¬	ennemys soubz ses piedz. Et au dernier la mort en¬
choses soubz ses piedz. 1.Corin.15.d. Heb.2.b.	choses soubz ses piedz. 1.Corin.15.d. Heb.2.b.
te principaute/ ⁊ puissance/ ⁊ uertu/ ⁊ domination/	te principaute/ et puissance/ et vertu/ et domination/
⁊ tout nom lequel est nomme: non seulement en ce	et tout nom lequel est nomme: non seulement en ce
assubiecty toutes choses soubz les piedz diceluy/	assubjecty toutes choses soubz les piedz d’iceluy/
le corps diceluy/ et la plenitude de celuy qui est	le corps d’iceluy/ et la plenitude de celuy qui est
laccomplissement de toutes choses en toutes.	l’accomplissement de toutes choses en toutes.
En luy toute plenitude de diuinite abõde corpo¬	En luy toute plenitude de divinite abonde corpo¬
toute principaute ⁊ puissance. Colos.2.b.	toute principaute et puissance. Colos.2.b.
Conceu du sainct esperit.	Conceu du sainct esperit.
treshaut sera obumbree en toy. Luc.1.d.	tres haut sera obumbree en toy. Luc.1.d.
Nay de la uierge Marie.	Nay de la vierge Marie.
Uoicy la uierge conceuera/ ⁊ enfantera un en¬	Voicy la vierge concevera/ et enfantera un en¬
Quãd lacõplissement du tẽps fut uenu/ Dieu	Quand l’acomplissement du temps fut venu/ Dieu
Ayãt souffert soubz Põce Pilate ⁊c.	Ayant souffert soubz Ponce Pilate etc.
Ueritablemẽt Herode ⁊ Ponce Pilate auec les	Veritablement Herode et Ponce Pilate avec les
de ton sainct filz Iesus. Act.4.f. Mat.27.d.	de ton sainct filz Jesus. Act.4.f. Mat.27.d.
late/ bonne confession. 1.Timo.6.c.	late/ bonne confession. 1.Timo.6.c.
Ueritablemẽt il a prins sur soy noz infirmitez/	Veritablement il a prins sur soy noz infirmitez/
Il failloit que Christ souffrit. Luc.24.g.	Il failloit que Christ souffrit. Luc.24.g.
euesq̃s respõdirẽt. Nous nauõs point de roy/ sinõ	evesques respondirent. Nous n’avons point de roy/ sinon
Cesar. Alors dõc il leur liura iceluy pour le cruci¬	Cesar. Alors donc il leur livra iceluy pour le cruci¬
luy portãt la croix ⁊c. Iehã.19.d. Mat.27.d.	luy portant la croix etc. Jehã.19.d. Mat.27.d.
en ce que quãd nous estiõs encore pecheurs Christ	en ce que quand nous estions encore pecheurs Christ
est mort pour nous. Ro.5.b.	est mort pour nous. Ro.5.b.
exẽple/ affin que ensuyuiez ses pas. 1.Pier.2.d.	exemple/ affin que ensuyviez ses pas. 1.Pier.2.d.
poͬ les iniustes/ affin qͥl noꝰ offrit a dieu/ mortifiez	pour les injustes/ affin qu’il nous offrit a dieu/ mortifiez
certes en chair/ mais uiuifiez en esperit. 1.Pier.3.c.	certes en chair/ mais vivifiez en esperit. 1.Pier.3.c.
uent ne uiuẽt plus a eux/ mais a celuy qͥ est mort	vent ne vivent plus a eux/ mais a celuy qui est mort
Ioseph le print/ et le enueloppa de ung linceul	Joseph le print/ et le enveloppa de ung linceul
net/ ⁊ le mist en son monumẽt neuf/ lequel il auoit	net/ et le mist en son monument neuf/ lequel il avoit
Christ est mort pour noz pechez/ il a este enseue¬	Christ est mort pour noz pechez/ il a este enseve¬
escriptures. 1.Corin.15.a.	escriptures. 1.Corin.15.a.
Sẽtez en uous ce qui a este en Iesus Christ: leq̃l	Sentez en vous ce qui a este en Jesus Christ: lequel
point repute larcin estre esgal a Dieu: mais il sest	point repute larcin estre esgal a Dieu: mais il s’est
faict en la similitude des hõmes/ ⁊ trouue en appa	faict en la similitude des hommes/ et trouve en appa¬
rẽce cõme hõme. Il sest humilie soymesme ⁊ a este	rence comme homme. Il s’est humilie soymesme et a este
la croix. Philip.2.a.	la croix. Philip.2.a.
des mortz.	des mortz.
Ainsi cõme Ionas fut au uentre de la baleine	Ainsi comme Jonas fut au ventre de la baleine
me au coeur de la terre/ troys iours ⁊ troys nuictz.	me au coeur de la terre/ troys jours et troys nuictz.
Luy preuoiãt a parle de la resurrectiõ de Christ/	Luy prevoiant a parle de la resurrection de Christ/
que il na point este de laisse en enfer/ ⁊ sa chair na	que il n’a point este de laisse en enfer/ et sa chair n’a
Il nest point icy/ car il est resuscite. Mat.28.a.	Il n’est point icy/ car il est resuscite. Mat.28.a.
re/ affin que uous eussiez foy et esperance enuers	re/ affin que vous eussiez foy et esperance envers
Dieu. 1.Pierre.1.d.	Dieu. 1.Pierre.1.d.
mortz: affin quil soit tenant le premier lieu en tou¬	mortz: affin qu’il soit tenant le premier lieu en tou¬
Il a este liure pour noz pechez/ et a este resuscite	Il a este livre pour noz pechez/ et a este resuscite
pour nostre iustification. Ro.4.d.	pour nostre justification. Ro.4.d.
re du pere/ pareillement aussi nous cheminons en	re du pere/ pareillement aussi nous cheminons en
Beneit soit Dieu ⁊ le pere de nr̃e Seigñr Iesus	Beneit soit Dieu et le pere de nostre Seigneur Jesus
Christ/ qͥ selõ sa grãde misericorde noꝰ a regenerez	Christ/ qui selon sa grande misericorde nous a regenerez
des mortz/ a lheritage ĩcorruptible ⁊c. 1.Pe.1.a.3.d.	des mortz/ a l’heritage incorruptible etc. 1.Pe.1.a.3.d.
Nul nest mõte au ciel/ sinon le filz de lhõme qui	Nul n’est monte au ciel/ sinon le filz de l’homme qui
est descendu du ciel. Iehã.3.b.	est descendu du ciel. Jehã.3.b.
estoit prisonniere/ il a donne dons aux hommes.	estoit prisonniere/ il a donne dons aux hommes.
Et apres que le Seigñr Iesus eut parle a eux/	Et apres que le Seigneur Jesus eut parle a eux/
il fut receu au ciel/ et se sied a la dextre de Dieu.	il fut receu au ciel/ et se sied a la dextre de Dieu.
Et quãd il eut dit ces choses/ il fut esleue/ iceux	Et quand il eut dit ces choses/ il fut esleve/ iceux
Iesus qui est receu dauec uous au ciel: uiẽdra ainsi	Jesus qui est receu d’avec vous au ciel: viendra ainsi
cõme lauez ueu aller au ciel. Act.1.a.	comme l’avez veu aller au ciel. Act.1.a.
Seigneur dit a mon Seigñr: Siedz a ma dextre/	Seigneur dit a mon Seigneur: Siedz a ma dextre/
tes piedz. Act.2.f. Hebr.1.a.	tes piedz. Act.2.f. Hebr.1.a.
Nous auõs tel euesque/ qui est assis a la dextre	Nous avons tel evesque/ qui est assis a la dextre
Lequel est a la dextre de Dieu/ monte au ciel/	Lequel est a la dextre de Dieu/ monte au ciel/
1.Pierre.3.d. Ephe.1.d.	1.Pierre.3.d. Ephe.1.d.
Il sied a la dextre du thrõne de Dieu. Heb.12.a.	Il sied a la dextre du thronne de Dieu. Heb.12.a.
eternellemẽt a la dextre de Dieu: du surplus iusq̃	eternellement a la dextre de Dieu: du surplus jusque
piedz. Hebr.10.c. 1.Corin.15.d.	piedz. Hebr.10.c. 1.Corin.15.d.
Il faut q̃ le ciel recoyue Christ/ iusque au tẽps	Il faut que le ciel recoyve Christ/ jusque au temps
Iesus nest point entre aux sainctuaires faictz	Jesus n’est point entre aux sainctuaires faictz
affin q̃ maintenãt il apparoisse pour nous deuant	affin que maintenant il apparoisse pour nous devant
la face de Dieu. Heb.9.f. Ro.8.g.	la face de Dieu. Heb.9.f. Ro.8.g.
monte sur tous les cieux/ affin quil emplit toutes	monte sur tous les cieux/ affin qu’il emplit toutes
Se uous estes resuscitez auec Christ/ cerchez les	Se vous estes resuscitez avec Christ/ cerchez les
choses qui sont denhaut ou Christ est seand a la	choses qui sont d’enhaut ou Christ est seand a la
Se aucun uous dit: uoicy icy est Christ/ ou la/	Se aucun vous dit: voicy icy est Christ/ ou la/
phetes se esleuerõt/ ⁊ ferõt grandz signes et prodi¬	phetes se esleveront/ et feront grandz signes et prodi¬
ges/ tellemẽt que les esleux seront induis a erreur/	ges/ tellement que les esleux seront induis a erreur/
il uous disent: Uoicy il est au desert/ ne y allez	il vous disent: Voicy il est au desert/ ne y allez
croyez point. Car ainsi que lesclair sort de Oriẽt/	croyez point. Car ainsi que l’esclair sort de Orient/
⁊ apparoit iusque en Occidẽt/ ainsi sera aussi lad¬	et apparoit jusque en Occident/ ainsi sera aussi l’ad¬
13.c. Luc.17.e. ⁊. 21.c.	13.c. Luc.17.e. et. 21.c.
Nul ne uous seduise. Car le Seigñr ne uiẽdra	Nul ne vous seduise. Car le Seigneur ne viendra
point q̃ premieremẽt ne soit uenue la defaillance/ ⁊	point que premierement ne soit venue la defaillance/ et
aduersaire/ ⁊ se eslieue sur tout ce qui est dit Dieu/	adversaire/ et se eslieve sur tout ce qui est dit Dieu/
temple de Dieu/ se mõstrant cõme sil estoit Dieu.	temple de Dieu/ se monstrant comme s’il estoit Dieu.
2.Thessalo.2.a.	2.Thessalo.2.a.
une foys/ ⁊ apres ce le iugemẽt/ ainsi aussi Christ	une foys/ et apres ce le jugement/ ainsi aussi Christ
sieurs/ ⁊ il apparoistra secondemẽt sans peche/ a	sieurs/ et il apparoistra secondement sans peche/ a
tous ceux qui lattendent en salut. Heb.9.g.	tous ceux qui l’attendent en salut. Heb.9.g.
neray de rechief/ ⁊ uous receuray moymesme/ affin	neray de rechief/ et vous recevray moymesme/ affin
Il auoit este cõstitue de Dieu/ iuge des uifz et	Il avoit este constitue de Dieu/ juge des vifz et
des mortz. Act̃.10.f.	des mortz. Act̃.10.f.
tout iugement/ affin que tous hõnorent le filz/ cõe	tout jugement/ affin que tous honnorent le filz/ comme
iuger: car il est le filz de lhõme. Iehã.5.d.	juger: car il est le filz de l’homme. Jehã.5.d.
A ce est mort ⁊ resuscite Christ/ affin quil ayt	A ce est mort et resuscite Christ/ affin qu’il ayt
tous assisterõs deuãt le siege iudicial de Christ ⁊c.	tous assisterons devant le siege judicial de Christ etc.
Rom̃.14.b.	Rom̃.14.b.
Il nous faut tous estre manifestes deuãt le sie-	Il nous faut tous estre manifestes devant le sie¬
les propres choses du corps/ ainsi quil a faict: soit	les propres choses du corps/ ainsi qu’il a faict: soit
Du surplus la courõne de iustice mest gardee/	Du surplus la couronne de justice m’est gardee/
laquelle me rendra le Seigñr dieu iuste iuge/ en ce	laquelle me rendra le Seigneur dieu juste juge/ en ce
ceux qui ayment son aduenement. 2.Timo.4.b.	ceux qui ayment son advenement. 2.Timo.4.b.
salo.2.a. 1.Thes.4.d. Ro.2.a.b. 2.Pe.3.b. Iud.1.g.	salo.2.a. 1.Thes.4.d. Ro.2.a.b. 2.Pe.3.b. Jud.1.g.
¶ Ie croy au sainct esperit.	¶ Je croy au sainct esperit.
Ie espãdray de mon esperit sur toute chair. Ioel	Je espandray de mon esperit sur toute chair. Joel
Ie uous enuoyeray la ꝓmesse du pere en uous:	Je vous envoyeray la promesse du pere en vous:
⁊ uous/ demourez en la cite de Hierusalem: iusque	et vous/ demourez en la cite de Hierusalem: jusque
Luc.24.g.	Luc.24.g.
commanda quilz ne departissent point de Hieru¬	commanda qu’ilz ne departissent point de Hieru¬
salem: mais quilz attendissent la promesse du pe¬	salem: mais qu’ilz attendissent la promesse du pe¬
certes Iehan a baptise deaue: et uous serez un	certes Jehan a baptise d’eaue: et vous serez un
Actes.1.a.	Actes.1.a.
Si uous me aymez: gardez mes commande¬	Si vous me aymez: gardez mes commande¬
nera lautre consolateur/ pour demourer auec	nera l’autre consolateur/ pour demourer avec
lequel le monde ne poeut receuoir: car il ne le	lequel le monde ne poeut recevoir: car il ne le
uoit point/ et si ne le congnoist point: mais uous	voit point/ et si ne le congnoist point: mais vous
en uous. Iehan.14.c.	en vous. Jehan.14.c.
pere enuoyera en mon nom) iceluy uous enseigne¬	pere envoyera en mon nom) iceluy vous enseigne¬
ra toutes choses/ ⁊ uous reduira en memoire tou¬	ra toutes choses/ et vous reduira en memoire tou¬
han.14.d.	han.14.d.
uous enuoyeray de mon pere/ lesperit de uerite	vous envoyeray de mon pere/ l’esperit de verite
qui procede du pere/ iceluy rendra tesmoignage	qui procede du pere/ iceluy rendra tesmoignage
uous estes des le commencement auec moy. Ie¬	vous estes des le commencement avec moy. Je¬
Si ie ne men uoys: le consolateur ne uiendra	Si je ne m’en voys: le consolateur ne viendra
point a uous. Et se ie men uoys/ ie le uous en¬	point a vous. Et se je m’en voys/ je le vous en¬
dra le monde de peche/ et de iustice/ et de iuge¬	dra le monde de peche/ et de justice/ et de juge¬
creu en moy. Et de iustice: car ie men uoys a	creu en moy. Et de justice: car je m’en voys a
mon pere/ et plus ne me uerrez. Et de iugement:	mon pere/ et plus ne me verrez. Et de jugement:
Quãd iceluy uiendra qui est lesperit de uerite/ il	Quand iceluy viendra qui est l’esperit de verite/ il
Iceluy uous baptisera en sainct esperit et feu.	Iceluy vous baptisera en sainct esperit et feu.
Matth.3.c.	Matth.3.c.
rit/ il ne poeut entrer au royaume de Dieu. Ie¬	rit/ il ne poeut entrer au royaume de Dieu. Je¬
Lesperit inspire la ou il ueut/ et tu oys sa	L’esperit inspire la ou il veut/ et tu oys sa
uoix: mais tu ne scais dont elle uient/ ne la ou	voix: mais tu ne scais dont elle vient/ ne la ou
rit. Iehan.3.a.	rit. Jehan.3.a.
Seigneur/ la est liberte. 2.Corin.3.d.	Seigneur/ la est liberte. 2.Corin.3.d.
Ce nestes uous point qui parlez: mais cest	Ce n’estes vous point qui parlez: mais c’est
thieu.10.b.	thieu.10.b.
scauons point quelle chose nous deuons prier	scavons point quelle chose nous devons prier
comme il appartient: mais lesperit mesme prie	comme il appartient: mais l’esperit mesme prie
mains.8.e.	mains.8.e.
sainct esperit de promission/ qui est arre de nostre	sainct esperit de promission/ qui est arre de nostre
heritage. Ephe.1.c.	heritage. Ephe.1.c.
⁊ qui nous a oingt/ est Dieu: ⁊ celuy qui nous a	et qui nous a oingt/ est Dieu: et celuy qui nous a
2.Corinth.1.d.	2.Corinth.1.d.
Quiconque na lesperit de Christ/ il nest point	Quiconque n’a l’esperit de Christ/ il n’est point
Quicõques sont menez par lesperit de Dieu/	Quiconques sont menez par l’esperit de Dieu/
Pource que uous estes enfans de dieu: dieu a	Pource que vous estes enfans de dieu: dieu a
enuoye lesperit de sõ filz en uoz coeurs criãt Abba	envoye l’esperit de son filz en voz coeurs criant Abba
Certes celuy esperit rend tesmoignage a nostre	Certes celuy esperit rend tesmoignage a nostre
Dieu le nous a reuele par sõ esperit. Car lespe¬	Dieu le nous a revele par son esperit. Car l’espe¬
rit enquiert profondement toutes choses: aussi les	rit enquiert profondement toutes choses: aussi les
qui scait les choses de lhomme: sinon lesperit de	qui scait les choses de l’homme: sinon l’esperit de
les choses qui sont de Dieu nul ne les a congneu/	les choses qui sont de Dieu nul ne les a congneu/
sinon lesperit de Dieu. Et nous nauons point re¬	sinon l’esperit de Dieu. Et nous n’avons point re¬
affin que nous congnoissions les choses qui nous	affin que nous congnoissions les choses qui nous
Pour ce ie uous fay ascauoir: que nul parlant	Pour ce je vous fay ascavoir: que nul parlant
par lesperit de dieu/ ne dit parolle execrable de Ie¬	par l’esperit de dieu/ ne dit parolle execrable de Je¬
le sainct esperit. Il y a diuisions de graces: mais il	le sainct esperit. Il y a divisions de graces: mais il
Un mesme esperit faict toutes ces choses/ de¬	Un mesme esperit faict toutes ces choses/ de¬
partant a un chascun ainsi quil ueut. Car nous	partant a un chascun ainsi qu’il veut. Car nous
1.Corin.12.b.	1.Corin.12.b.
nom du pere ⁊ du filz ⁊ du saĩct esperit. Mat.28.d.	nom du pere et du filz et du sainct esperit. Mat.28.d.
Tous pechez seront pardonnez aux filz des hõ¬	Tous pechez seront pardonnez aux filz des hom¬
qui blasphemera contre le sainct esperit/ il naura	qui blasphemera contre le sainct esperit/ il n’aura
pable de eternel iugemẽt. Marc.3.d. Matth.12.c.	pable de eternel jugement. Marc.3.d. Matth.12.c.
Luc.12.b. Hebr.6.a.	Luc.12.b. Hebr.6.a.
nion des sainctz.	nion des sainctz.
uant/ colomne ⁊ fermete de uerite. 1.Timo.3.d.	vant/ colomne et fermete de verite. 1.Timo.3.d.
Les femmes soiẽt subiectes a leur maris/ ainsi	Les femmes soient subjectes a leur maris/ ainsi
femme: ainsi que Christ est chief de leglise: ⁊ iceluy	femme: ainsi que Christ est chief de l’eglise: et iceluy
subiecte a Christ: ainsi aussi les femmes soient a	subjecte a Christ: ainsi aussi les femmes soient a
leͬs maris en toutes choses. Uous marys/ aymez	leurs maris en toutes choses. Vous marys/ aymez
dõne soymesme pour elle/ affin qui la sanctifiast/	donne soymesme pour elle/ affin qui la sanctifiast/
de uie/ affin quil rendist a soy leglise glorieuse/	de vie/ affin qu’il rendist a soy l’eglise glorieuse/
nayant q̃lque tache/ ou ride/ ou aucune telle cho¬	n’ayant quelque tache/ ou ride/ ou aucune telle cho¬
Nous sommes membres de son corps/ de sa chair/	Nous sommes membres de son corps/ de sa chair/
Christ ⁊ en leglise. Ephe.5.e.	Christ et en l’eglise. Ephe.5.e.
Iceluy est le chief du corps de leglise. Colo.1.d.	Iceluy est le chief du corps de l’eglise. Colo.1.d.
Nul ne poeut mettre autre fõdemẽt q̃ celuy qui	Nul ne poeut mettre autre fondement que celuy qui
Sur le fõdemẽt des apostres ⁊ ꝓphetes. Eph.2.d	Sur le fondement des apostres et prophetes. Eph.2.d
Et la pierre estoit Christ. 1.Cor.10.a. 1.Pier.2.b.	Et la pierre estoit Christ. 1.Cor.10.a. 1.Pier.2.b.
Christ comme filz a administre la maison dice¬	Christ comme filz a administre la maison d’ice¬
ferme fiance ⁊ gloriation de lesperance/ iusque a la	ferme fiance et gloriation de l’esperance/ jusque a la
fin. Hebr.3.b.	fin. Hebr.3.b.
doulx/ duquel uous approchans/ qui est la pierre	doulx/ duquel vous approchans/ qui est la pierre
honnoree de Dieu. Soyez comme pierres uiues/	honnoree de Dieu. Soyez comme pierres vives/
edifiez sur elle/ en une maison spirituelle/ en un sa¬	edifiez sur elle/ en une maison spirituelle/ en un sa¬
sacerdoce royal/ la gent saincte/ le peuple dacqui¬	sacerdoce royal/ la gent saincte/ le peuple d’acqui¬
Uous nestes donc plus estrangiers ⁊ pelerins:	Vous n’estes donc plus estrangiers et pelerins:
mais uous estes citoyens des sainctz/ et domestic¬	mais vous estes citoyens des sainctz/ et domestic¬
stres et prophetes/ qui est la treshaute pierre angu¬	stres et prophetes/ qui est la tres haute pierre angu¬
struicte croist en un temple sainct en nostre Sei¬	struicte croist en un temple sainct en nostre Sei¬
gneur/ auquel uous aussi estes edifiez en un ta¬	gneur/ auquel vous aussi estes edifiez en un ta¬
Cestuy a donne/ aucuns pour estre apostres/	Cestuy a donne/ aucuns pour estre apostres/
autres pasteurs et docteurs pour la perfection	autres pasteurs et docteurs pour la perfection
des sainctz a loeuure de ladministration/ a ledi¬	des sainctz a l’oeuvre de l’administration/ a l’edi¬
tous allions au deuant en unite de foy et de con¬	tous allions au devant en unite de foy et de con¬
mesure de leage de la plenitude de Christ ⁊c.	mesure de l’eage de la plenitude de Christ etc.
Ephesiens.4.c.	Ephesiens.4.c.
de perfection/ ⁊ la paix de Christ soit en liesse en	de perfection/ et la paix de Christ soit en liesse en
corps. Colos.2.c.	corps. Colos.2.c.
Ne scauez uous pas que uous estes le temple de	Ne scavez vous pas que vous estes le temple de
se aucun uiole le temple de Dieu/ Dieu le destrui¬	se aucun viole le temple de Dieu/ Dieu le destrui¬
estes. 1.Corin.3.d.	estes. 1.Corin.3.d.
Ne scauez uous pas bien que uoz corps sont les	Ne scavez vous pas bien que voz corps sont les
membres sont le temple du sainct esperit/ qui est en	membres sont le temple du sainct esperit/ qui est en
a uous. Certes uous estes achetez de grand pris/	a vous. Certes vous estes achetez de grand pris/
glorifiez/ et portez dieu en uostre corps. 1.Corin¬	glorifiez/ et portez dieu en vostre corps. 1.Corin¬
Uous certes estes le tẽple de dieu uiuãt: ainsi q̃	Vous certes estes le temple de dieu vivant ainsi que
eux/ ⁊ ie seray leur dieu/ et ilz seront mon peuple.	eux/ et je seray leur dieu/ et ilz seront mon peuple.
2.Corin.6.d. 3.Moyse.26.b.	2.Corin.6.d. 3.Moyse.26.b.
Plusieurs faisons un corps en Christ. Roma.	Plusieurs faisons un corps en Christ. Roma.
Plusieurs sõmes un pain/ un corps: car nous	Plusieurs sommes un pain/ un corps: car nous
participõs tous dun mesme pain. 1.Corin.10.d.	participons tous d’un mesme pain. 1.Corin.10.d.
tous sont dun. Heb.2.c.	tous sont d’un. Heb.2.c.
aussi uous soyez sainctz en toute cõuersation: car	aussi vous soyez sainctz en toute conversation: car
il est escrit/ Uous serez sainctz/ car ie suis sainct.	il est escrit/ Vous serez sainctz/ car je suis sainct.
Rendans graces au pere/ qui nous a faict di¬	Rendans graces au pere/ qui nous a faict di¬
re/ qui nous a deliure de la puissãce des tenebres/	re/ qui nous a delivre de la puissance des tenebres/
⁊ nous a transportez au royaume du filz de sa dile	et nous a transportez au royaume du filz de sa dile
La uerite de dieu est en leglise des sainctz. Psal¬	La verite de dieu est en l’eglise des sainctz. Psal¬
Se il ne oyt point iceux dy le a leglise. Et sil	Se il ne oyt point iceux dy le a l’eglise. Et s’il
ne oyt point leglise/ il te soit cõme payen ou pu¬	ne oyt point l’eglise/ il te soit comme payen ou pu¬
mon nom/ ie suis la au millieu de eux. Mat.18.c.	mon nom/ je suis la au millieu de eux. Mat.18.c.
portes denfer ne pourront rien a lencontre delle.	portes d’enfer ne pourront rien a l’encontre d’elle.
Matth.16.c.	Matth.16.c.
de leglise/ instituez par Ie¬	de l’eglise/ instituez par Je¬
¶ Du baptesme.	¶ Du baptesme.
Allez par tout le monde/ ⁊ preschez leuangile a	Allez par tout le monde/ et preschez l’evangile a
sauue. Mais qui ne croyra point/ il sera condẽne.	sauve. Mais qui ne croyra point/ il sera condemne.
Iehan certes a baptise deaue: mais uoꝰ serez ba¬	Jehan certes a baptise d’eaue: mais vous serez ba¬
ptisez/ du sainct esperit. Act̃.11.a.1.c. Matth.3.c.	ptisez/ du sainct esperit. Act̃.11.a.1.c. Matth.3.c.
ne poeut entrer au royaume de dieu. Iehan.3.a.	ne poeut entrer au royaume de dieu. Jehan.3.a.
icelle figure nous sauue/ non point en ostãt lordu¬	icelle figure nous sauve/ non point en ostant l’ordu¬
re de la chair/ mais en bonne cõscience respondant	re de la chair/ mais en bonne conscience respondant
¶ De la table de nostre Seigñr.	¶ De la table de nostre Seigneur.
quand il eu rendu graces le rõpit/ ⁊ le dõna a ses	quand il eu rendu graces le rompit/ et le donna a ses
disciples/ ⁊ dit: Prenez/ mangez: ce/ est mon corps.	disciples/ et dit: Prenez/ mangez: ce/ est mon corps.
disant: Beuuez tous de ce. Car ce/ est mon sang du	disant: Beuvez tous de ce. Car ce/ est mon sang du
sieurs en la remission des pechez. Et uous dy: Ie	sieurs en la remission des pechez. Et vous dy: Je
ne beuuray doresnauant de ce germe de uigne: iusq̃	ne beuvray doresnavant de ce germe de vigne: jusque
auec uous au royaume de mon pere. Et quãd ilz	avec vous au royaume de mon pere. Et quand ilz
la mõtaigne de Oliuet. Matth.26.c. Marc.14.c.	la montaigne de Olivet. Matth.26.c. Marc.14.c.
Luc.22.b.	Luc.22.b.
baille: que nostre Seigneur Iesus: en la nuict en	baille: que nostre Seigneur Jesus: en la nuict en
du graces le rompit/ ⁊ dit: Prenez/ mangez: ce/ est	du graces le rompit/ et dit: Prenez/ mangez: ce/ est
mon corps/ qui est rompu pour uous. Faictes cecy	mon corps/ qui est rompu pour vous. Faictes cecy
ce/ apres qͥl eut souppe: disãt/ Ce calice est le nou¬	ce/ apres qu’il eut souppe: disant/ Ce calice est le nou¬
les foys que le beuurez/ en memoire de moy. Car	les foys que le beuvrez/ en memoire de moy. Car
toutes les foys/ que uous mangerez ce pain ⁊ beu¬	toutes les foys/ que vous mangerez ce pain et beu¬
gneur/ iusque a ce quil uienne ⁊c. 1.Corinthiens	gneur/ jusque a ce qu’il vienne etc. 1.Corinthiens
La remission des pechez.	La remission des pechez.
Et affin que sachez que le filz de lhõme a puis¬	Et affin que sachez que le filz de l’homme a puis¬
Paraliticque: Ie te dy/ lieue toy ⁊c. Marc.2.b.	Paraliticque: Je te dy/ lieve toy etc. Marc.2.b.
ten en paix ⁊ ne peche plus. Luc.7.g.	t’en en paix et ne peche plus. Luc.7.g.
Uoicy laigneau de Dieu/ qui oste le peche du	Voicy l’aigneau de Dieu/ qui oste le peche du
Il est un Dieu ⁊ un mediateur de Dieu ⁊ des	Il est un Dieu et un mediateur de Dieu et des
mesme en redemption pour tous. 1.Timo.2.b.	mesme en redemption pour tous. 1.Timo.2.b.
Si aucun a peche nous auons un aduocat	Si aucun a peche nous avons un advocat
lapointement pour noz pechez/ et non seullement	l’apointement pour noz pechez/ et non seullement
monde. 1.Ieh.2.a. Rom̃.8.g.	monde. 1.Jeh.2.a. Rom̃.8.g.
Uous estes de par luy en Iesus Christ qui noꝰ	Vous estes de par luy en Jesus Christ qui nous
ption. 1.Corin.1.d.	ption. 1.Corin.1.d.
Ie suis la lumiere. Iehan.8.b.	Je suis la lumiere. Jehan.8.b.
Il est nostre paix. Ephe.2.c.	Il est nostre paix. Ephe.2.c.
Ie suis la uoye/ la uerite ⁊ la uie. Nul ne uiẽt a	Je suis la voye/ la verite et la vie. Nul ne vient a
Il estoit cõuenable/ que celuy pour lequel sont	Il estoit convenable/ que celuy pour lequel sont
toutes choses qui auoit amene beaucoup denfans	toutes choses qui avoit amene beaucoup d’enfans
passion. Hebr.2.c.	passion. Hebr.2.c.
auoir compassiõ de noz infirmitez: mais celuy qui	avoir compassion de noz infirmitez: mais celuy qui
a este tente en toutes choses par similitude sans	a este tente en toutes choses par similitude sans
Cõsiderez lapostre ⁊ euesque de nostre cõfession	Considerez l’apostre et evesque de nostre confession
cõme Moyse en toute sa maison. Heb.3.a.	comme Moyse en toute sa maison. Heb.3.a.
Et luy qui a este parfaict a este faict cause de	Et luy qui a este parfaict a este faict cause de
pelle euesque selon lordre de Melchisedec. He-	pelle evesque selon l’ordre de Melchisedec. He¬
Il poeut sauuer a perpetuite ceux qͥ sapprochẽt	Il poeut sauver a perpetuite ceux qui s’approchent
de dieu par luy/ uiuãt a tousioͬs poͬ ĩterceder poͬ	de dieu par luy/ vivant a tousjours pour interceder pour
uesq̃/ saĩct/ innocẽt/ sãs macule/ separe des pecheͬs	vesque/ sainct/ innocent/ sans macule/ separe des pecheurs
Le sang de Christ qui par le sainct esperit sest	Le sang de Christ qui par le sainct esperit s’est
offert a dieu soymesme sãs macule/ combien plus	offert a dieu soymesme sans macule/ combien plus
tes pour seruir a dieu uiuãt? Et pour ce est il media	tes pour servir a dieu vivant? Et pour ce est il media¬
la mort/ ceux qui sont appellez recoiuẽt la ꝓmesse	la mort/ ceux qui sont appellez recoivent la promesse
de leternel heritage/ ⁊ la redemption des trãsgres¬	de l’eternel heritage/ et la redemption des transgres¬
Hebrieux.9.c.	Hebrieux.9.c.
par loblation une foys faicte du corps de Iesus	par l’oblation une foys faicte du corps de Jesus
Christ: ⁊c. Car par une oblation il a parfaict per¬	Christ: etc. Car par une oblation il a parfaict per¬
sion dicelles/ il ny a plus doblation pour le peche.	sion d’icelles/ il n’y a plus d’oblation pour le peche.
Ie suis lhuys. Se aucun entre par moy il sera	Je suis l’huys. Se aucun entre par moy il sera
sauue: ⁊ entrera ⁊ sortira/ ⁊ trouuera pastures: Le	sauve: et entrera et sortira/ et trouvera pastures: Le
struire. Ie suis uenu affin quelles ayent uie: et	struire. Je suis venu affin qu’elles ayent vie: et
pasteur. Le bon pasteur donne sa uie pour ses bre¬	pasteur. Le bon pasteur donne sa vie pour ses bre¬
bis. Mais le mercenaire nest point pasteur. Ie¬	bis. Mais le mercenaire n’est point pasteur. Je¬
Il purgera toute brãche qui porte fruict/ affin	Il purgera toute branche qui porte fruict/ affin
Lequel a porte noz pechez en son corps sur le	Lequel a porte noz pechez en son corps sur le
boys/ affin que nous estans mortz a pechez uiuiõs	boys/ affin que nous estans mortz a pechez vivions
Car uous estiez cõme brebis errantes/ mais maint¬	Car vous estiez comme brebis errantes/ mais maint¬
ames. 1.Pet̃.2.d.	ames. 1.Pet̃.2.d.
Uiuez en crainte au temps de uostre pelerina¬	Vivez en crainte au temps de vostre pelerina¬
ne conuersation de la tradition de uoz peres: non	ne conversation de la tradition de voz peres: non
mais par le sang precieux de Christ/ qui est com¬	mais par le sang precieux de Christ/ qui est com¬
me laigneau incontamine et sans macule. 1.Pier	me l’aigneau incontamine et sans macule. 1.Pier¬
Il est ainsi escrit: et ainsi failloit que le Christ	Il est ainsi escrit: et ainsi failloit que le Christ
on preschast en son nom repentance et remission	on preschast en son nom repentance et remission
des pechez/ en toutes gens. Luc.24.g.	des pechez/ en toutes gens. Luc.24.g.
ge q̃ tous ceux qui croirõt en luy/ receurõt remissiõ	ge que tous ceux qui croiront en luy/ recevront remission
Il ny a poĩt de salut en aucun autre. Car aussi	Il n’y a point de salut en aucun autre. Car aussi
ny a il point dautre nom dõne entre les hõmes/ au	n’y a il point d’autre nom donne entre les hommes/ au¬
Par celuy uous est annonce la remission des	Par celuy vous est annonce la remission des
Actes.13.f.	Actes.13.f.
Repentez uous/ ⁊ soit chascun baptize au nom	Repentez vous/ et soit chascun baptize au nom
Le sang de son filz nous nettoye de tout peche	Le sang de son filz nous nettoye de tout peche
Par lequel nous auons redemption par son	Par lequel nous avons redemption par son
sang: remission des pechez. Coloss.1.b. Ephe.1.b.	sang: remission des pechez. Coloss.1.b. Ephe.1.b.
Quãd la benignite ⁊ amour du sauueur nostre	Quand la benignite et amour du sauveur nostre
les oeuures de iustice/ que nous faisions/ mais par	les oeuvres de justice/ que nous faisions/ mais par
sa misericorde nous a sauuez/ par le lauemẽt de la	sa misericorde nous a sauvez/ par le lavement de la
a espandu abondãment en nous par Iesus Christ	a espandu abondamment en nous par Jesus Christ
sa grace/ soyõs heritiers selon lesperance de la uie	sa grace/ soyons heritiers selon l’esperance de la vie
eternelle. Tit.3.a.2.c.	eternelle. Tit.3.a.2.c.
pery. Matthieu.18.b. Luc.19.b.	pery. Matthieu.18.b. Luc.19.b.
qui sont/ soit en terre ou eis cieux. Colos.1.c.	qui sont/ soit en terre ou eis cieux. Colos.1.c.
Faisant la purgation de noz pechez par soy¬	Faisant la purgation de noz pechez par soy¬
Pour reparer toutes choses par Christ/ lesquel	Pour reparer toutes choses par Christ/ lesquel¬
iceluy/ par lequel aussi nous sommes appellez a	iceluy/ par lequel aussi nous sommes appellez a
lheritage/ predestinez selon son bon plaisir ⁊c.	l’heritage/ predestinez selon son bon plaisir etc.
Nous donc qui sommes iustifiez par foy/ nous	Nous donc qui sommes justifiez par foy/ nous
sus Christ/ par lequel nous auõs acces par foy en	sus Christ/ par lequel nous avons acces par foy en
ceste grace ⁊c. Par plus forte raison dõc nous qui	ceste grace etc. Par plus forte raison donc nous qui
deliurez de ire par luy. Car lors que nous estions	delivrez de ire par luy. Car lors que nous estions
mort de son filz: par plus forte raison nous qui	mort de son filz: par plus forte raison nous qui
sommes recõciliez serons sauuez en la uie diceluy.	sommes reconciliez serons sauvez en la vie d’iceluy.
Uenez a moy uous tous qui estes trauaillez/	Venez a moy vous tous qui estes travaillez/
thieu.11.d.	thieu.11.d.
Dieu na pas enuoye son filz au monde pour	Dieu n’a pas envoye son filz au monde pour
ue par luy. Qui croyt en luy il nest point iuge:	ve par luy. Qui croyt en luy il n’est point juge:
point au nom du seul filz de Dieu. Et ce est le iu¬	point au nom du seul filz de Dieu. Et ce est le ju¬
gement: car la lumiere est uenue au mõde/ ⁊ les hõ	gement: car la lumiere est venue au monde/ et les hom¬
Iehan.3.b.	Jehan.3.b.
enuoye/ il a uie eternelle ⁊ ne uient point en con¬	envoye/ il a vie eternelle et ne vient point en con¬
demnation: mais passera de la mort en la uie.	demnation: mais passera de la mort en la vie.
En ce est apparue la charite de Dieu enuers	En ce est apparue la charite de Dieu envers
de/ affin que nous uiuions par luy. En ce est la	de/ affin que nous vivions par luy. En ce est la
charite/ non point pourtant que nous ayons ay¬	charite/ non point pourtant que nous ayons ay¬
me/ ⁊ a enuoye son filz reconciliation pour noz pe¬	me/ et a envoye son filz reconciliation pour noz pe¬
Il ny a nulle condemnation en ceux qui sont	Il n’y a nulle condemnation en ceux qui sont
en Iesus Christ: qui ne cheminent point selon la	en Jesus Christ: qui ne cheminent point selon la
ma deliure de la loy de peche et de mort. Ro¬	m’a delivre de la loy de peche et de mort. Ro¬
Uous estiez ces choses/ mais uoꝰ estes nettoyez/	Vous estiez ces choses/ mais vous estes nettoyez/
uous estes sanctifiez/ uoꝰ estes iustifiez par le nom	vous estes sanctifiez/ vous estes justifiez par le nom
1.Corin.6.c.	1.Corin.6.c.
a tous ⁊ sur tous ceux qui croyent en luy. Certes	a tous et sur tous ceux qui croyent en luy. Certes
il ny a point de differẽce. Tous ont peche ⁊ ont be¬	il n’y a point de difference. Tous ont peche et ont be¬
par la grace diceluy/ par la redẽption laquelle est	par la grace d’iceluy/ par la redemption laquelle est
cõciliateur par le sang diceluy/ a ceux qui ont foy.	conciliateur par le sang d’iceluy/ a ceux qui ont foy.
Romains.3.c.d.	Romains.3.c.d.
Ie scay que mõ redempteur uit/ ⁊ que au dernier	Je scay que mon redempteur vit/ et que au dernier
resuestu de ma peau/ ⁊ uerray Dieu en ma chair.	resvestu de ma peau/ et verray Dieu en ma chair.
Iob.19.d.	Job.19.d.
esuyde se deseiche/ ainsi lhõme apres qͥl est endor¬	esvyde se deseiche/ ainsi l’homme apres qu’il est endor¬
iusque a ce que le ciel soit brise/ ⁊ ne se releuera pas	jusque a ce que le ciel soit brise/ et ne se relevera pas
de son somme. Iob.14.b.	de son somme. Job.14.b.
Isa.16.d.	Isa.16.d.
de ma resurrectiõ au temps aduenir. Car mon iu¬	de ma resurrection au temps advenir. Car mon ju¬
gement est/ de assembler les nations ⁊ recueiller les	gement est/ de assembler les nations et recueiller les
Leternel Dieu dit ces choses a ces os: Uoicy ie	L’eternel Dieu dit ces choses a ces os: Voicy je
uous donneray des nerfz/ et feray uenir sur uous	vous donneray des nerfz/ et feray venir sur vous
la chair/ ⁊ estenderay sur uous la peau/ ⁊ uous dõ	la chair/ et estenderay sur vous la peau/ et vous don¬
suis le Seigneur ⁊c. Et lesperit est entre en eux/ et	suis le Seigneur etc. Et l’esperit est entre en eux/ et
⁊ estoit un moult grand exercite ⁊c. Et uous tous	et estoit un moult grand exercite etc. Et vous tous
peuple cõgnoistrez que ie suis le Seigneur/ quand	peuple congnoistrez que je suis le Seigneur/ quand
de uoz fosses/ ⁊ donneray en uous mon esperit/ ⁊	de voz fosses/ et donneray en vous mon esperit/ et
Et en ce temps la sera sauue mon peuple/ qui¬	Et en ce temps la sera sauve mon peuple/ qui¬
conque sera trouue escrit au liure. Lors plusieurs	conque sera trouve escrit au livre. Lors plusieurs
ueilleront/ aucuns en uie eternelle: les autres en	veilleront/ aucuns en vie eternelle: les autres en
Daniel.12.a.	Daniel.12.a.
Ie suis le Dieu de Abrahã/ ⁊ le Dieu de Isaac/	Je suis le Dieu de Abraham/ et le Dieu de Isaac/
mais des uiuans. Matth.25.c.	mais des vivans. Matth.25.c.
Ie scay quil resuscitera a la resurrection au der¬	Je scay qu’il resuscitera a la resurrection au der¬
nier iour. Iehã.11.c.	nier jour. Jehã.11.c.
toutes les choses qui sont escriptes en la loy ⁊ eis	toutes les choses qui sont escriptes en la loy et eis
rection des iustes ⁊ iniustes aduiendra/ laq̃lle aussi	rection des justes et injustes adviendra/ laquelle aussi
eux mesmes attendent. Act.24.d.	eux mesmes attendent. Act.24.d.
aux monumens orront la uoix du filz de Dieu.	aux monumens orront la voix du filz de Dieu.
de uie: Mais ceux qui auront faict mal/ en resur¬	de vie: Mais ceux qui auront faict mal/ en resur¬
rection de iugemẽt. Iehã.5.d. Matth.25.d.	rection de jugement. Jehã.5.d. Matth.25.d.
uous serez manifestez auec luy en gloire. Col.3.a.	vous serez manifestez avec luy en gloire. Col.3.a.
ceux qui dormẽt: affin que ne soyez contristez ainsi	ceux qui dorment: affin que ne soyez contristez ainsi
que les autres: qui nont point desperance. Car si	que les autres: qui n’ont point d’esperance. Car si
aussi Dieu amenera auec luy ceux qui dorment	aussi Dieu amenera avec luy ceux qui dorment
rolle de nostre Seigneur: que nous qui uiuerons/	rolle de nostre Seigneur: que nous qui viverons/
qui sommes le residu en laduenemẽt de nostre Sei	qui sommes le residu en l’advenement de nostre Sei¬
Car iceluy Seigneur au cõmandement ⁊ en uoix	Car iceluy Seigneur au commandement et en voix
ciel ⁊ les mortz qui sont en Christ/ resusciterõt pre¬	ciel et les mortz qui sont en Christ/ resusciteront pre¬
mierement. Puis apres nous qui uiuerons: qui se¬	mierement. Puis apres nous qui viverons: qui se¬
nuees au deuant du Seigñr en lair. Et ainsi nous	nuees au devant du Seigneur en l’air. Et ainsi nous
Affin que ne eussions cõfiance en nous mesme/	Affin que ne eussions confiance en nous mesme/
mais en Dieu/ lequel resuscite les mortz a uie.	mais en Dieu/ lequel resuscite les mortz a vie.
Maintenãt Christ est resuscite des mortz le pre	Maintenant Christ est resuscite des mortz le pre¬
par un hõme: ⁊ par un homme la resurrection des	par un homme: et par un homme la resurrection des
mortz. Et cõme tous meurẽt par Adam/ ainsi aussi	mortz. Et comme tous meurent par Adam/ ainsi aussi
ordre. Le premier est Christ: apres ceux qui sont de	ordre. Le premier est Christ: apres ceux qui sont de
Uoicy ie uous dy un mystere. Certes nous ne dor¬	Voicy je vous dy un mystere. Certes nous ne dor¬
mirons point tous/ toutesfoys nous tous serons	mirons point tous/ toutesfoys nous tous serons
niere trompe. Car la trompe sonnera/ et les mortz	niere trompe. Car la trompe sonnera/ et les mortz
Car il faut que ce corruptible/ ueste incorruption:	Car il faut que ce corruptible/ veste incorruption:
⁊ ce mortel/ ueste immortalite. 1.Corin.15.d.	et ce mortel/ veste immortalite. 1.Corin.15.d.
enuoye/ ne le tire: ⁊ ie le resusciteray au dernier ioͬ.	envoye/ ne le tire: et je le resusciteray au dernier jour.
Mais nostre cõuersation est eis cieux/ dõt aussi	Mais nostre conversation est eis cieux/ dont aussi
nous attendõs le sauueur/ nostre Seigneur Iesus	nous attendons le sauveur/ nostre Seigneur Jesus
en le conformant au corps de sa clarte selon lope¬	en le conformant au corps de sa clarte selon l’ope¬
subiectir toutes choses a soy. Phił.3.d.	subjectir toutes choses a soy. Phił.3.d.
Appelle paoures/ debiles/ boiteux/ aueugles ⁊c.	Appelle paovres/ debiles/ boiteux/ aveugles etc.
des iustes. Luc.14.c.	des justes. Luc.14.c.
ruptiõ/ en la liberte de la gloire des enfãs de dieu.	ruption/ en la liberte de la gloire des enfans de dieu.
Nous scauõs certes que toute creature gemit ⁊ tra	Nous scavons certes que toute creature gemit et tra¬
mais nous aussi qui auõs les premiers fruictz de	mais nous aussi qui avons les premiers fruictz de
dant ladoption des enfans de dieu la redemption	dant l’adoption des enfans de dieu la redemption
de nostre corps. Certainement nous sõmes sauuez	de nostre corps. Certainement nous sommes sauvez
Ilz uerront le filz de lhõme uenãt eis nuees du	Ilz verront le filz de l’homme venant eis nuees du
ses anges auec une trõpette de grande uoix/ ⁊ assẽ	ses anges avec une trompette de grande voix/ et assem¬
bleront ses esleux des quatre uens de la sommite	bleront ses esleux des quatre vens de la sommite
de ce iour la ⁊ heure nul ne scait/ ne les anges des	de ce jour la et heure nul ne scait/ ne les anges des
soyez prestz. Car le filz de lhõme uiendra a lheure	soyez prestz. Car le filz de l’homme viendra a l’heure
que ne pensez pas. Matthieu.24.c. ⁊. d.	que ne pensez pas. Matthieu.24.c. et. d.
La uie eternelle.	La vie eternelle.
aduenir.	advenir.
Sire/ a qui irõs nous/ tu as les parolles de uie	Sire/ a qui irons nous/ tu as les parolles de vie
Les parolles que ie uous dy/ sont esperit et uie.	Les parolles que je vous dy/ sont esperit et vie.
Ceste est la uie eternelle: que il te congnoissent	Ceste est la vie eternelle: que il te congnoissent
seul uray Dieu/ ⁊ Iesuchrist lequel tu as enuoye.	seul vray Dieu/ et Jesuchrist lequel tu as envoye.
Ie suis la resurrectiõ ⁊ la uie/ qui croit en moy/	Je suis la resurrection et la vie/ qui croit en moy/
croit en moy ne mourra poĩt eternellemẽt. Ieh.11.c.	croit en moy ne mourra point eternellement. Jeh.11.c.
Quiconque croit en luy ne perira point/ mais	Quiconque croit en luy ne perira point/ mais
En uerite/ en uerite/ ie uous dy/ que qui oyt ma	En verite/ en verite/ je vous dy/ que qui oyt ma
nelle. Et ne uiẽt point en cõdẽnation: mais passera	nelle. Et ne vient point en condemnation: mais passera
de la mort en la uie. Iehan.5.d.	de la mort en la vie. Jehan.5.d.
moy a la uie eternelle. Iehan.6.e.	moy a la vie eternelle. Jehan.6.e.
a la uie eternelle. Act̃.13.g. 1.Timo.1.d.	a la vie eternelle. Act̃.13.g. 1.Timo.1.d.
Et ce est le tesmoignage que dieu nous a donne	Et ce est le tesmoignage que dieu nous a donne
Uoyez.) Iehan.4.b.10.b.12.g. 1.Timoth.6.c.	Voyez.) Jehan.4.b.10.b.12.g. 1.Timoth.6.c.
¶ De la plaine uie aduenir.	¶ De la plaine vie advenir.
Quand le prince des pasteurs apparoistra/ uoꝰ	Quand le prince des pasteurs apparoistra/ vous
Et ceste est la promesse/ laquelle iceluy nous a	Et ceste est la promesse/ laquelle iceluy nous a
Il rendra a un chascun selõ ses oeuures: a ceux	Il rendra a un chascun selon ses oeuvres: a ceux
certes qui par perseuerã ce en bien faisant quierent	certes qui par perseverance en bien faisant quierent
Romains.2.b.	Romains.2.b.
dieu/ est uie eternelle/ par Iesus Christ nostre sei¬	dieu/ est vie eternelle/ par Jesus Christ nostre sei¬
gneur. Rom̃.6.d.	gneur. Rom̃.6.d.
heritiers/ heritiers certes de Dieu/ ⁊ coheritiers de	heritiers/ heritiers certes de Dieu/ et coheritiers de
estre glorifiez auec luy. Certainemẽt iestime q̃ les	estre glorifiez avec luy. Certainement j’estime que les
afflictions de ce tẽps/ ne sont point a accõparer a	afflictions de ce temps/ ne sont point a accomparer a
quil a congneu des le commencement: il les a de¬	qu’il a congneu des le commencement: il les a de¬
son filz/ affin quil soit le premier nay entre moult	son filz/ affin qu’il soit le premier nay entre moult
de freres. Et ceux quil a deuant definis: il les a	de freres. Et ceux qu’il a devant definis: il les a
aussi iustifiez. Et ceux qͥl a iustifiez: il les a aussi	aussi justifiez. Et ceux qu’il a justifiez: il les a aussi
Treschers nous sommes maintenant enfans	Tres chers nous sommes maintenant enfans
de Dieu: ⁊ nest point encore apparu ce que nous	de Dieu: et n’est point encore apparu ce que nous
nous serons semblables a luy. Car nous le uer¬	nous serons semblables a luy. Car nous le ver¬
en luy: il se sanctifie/ cõme aussi iceluy est sainct.	en luy: il se sanctifie/ comme aussi iceluy est sainct.
1.Iehan.3.a.	1.Jehan.3.a.
Christ en dieu. Et quand Christ apparoistra qui	Christ en dieu. Et quand Christ apparoistra qui
luy en gloire. Colos.3.a.	luy en gloire. Colos.3.a.
En la resurrection ilz ne se marierõt/ ne seront	En la resurrection ilz ne se marieront/ ne seront
Matth.22.c.	Matth.22.c.
qui mauez ensuiuy: quand le filz de lhomme sera	qui m’avez ensuivy: quand le filz de l’homme sera
assis sur le siege de sa maieste/ en la generation	assis sur le siege de sa majeste/ en la generation
thieu.19.d.	thieu.19.d.
conuertie en ioye ⁊c. Iehan.16.d.	convertie en joye etc. Jehan.16.d.
Nous uoyõs maintenãt par un miroer en ob¬	Nous voyons maintenant par un miroer en ob¬
nant en partie: mais adonc ie cõgnoistray cõme ie	nant en partie: mais adonc je congnoistray comme je
Uous auez receu a ioye le rauissement de uoz	Vous avez receu a joye le ravissement de voz
biens: cõgnoissans que uous auez meilleure ⁊ per¬	biens: congnoissans que vous avez meilleure et per¬
Nous nauons point icy cite permanente: mais	Nous n’avons point icy cite permanente: mais
Ie dõneray a mãger a celuy qui uaincra/ de lar	Je donneray a manger a celuy qui vaincra/ de l’ar¬
bre de uie/ lequel est au paradis de mon Dieu ⁊c.	bre de vie/ lequel est au paradis de mon Dieu etc.
ronne de uie. Apoca.2.b.c.	ronne de vie. Apoca.2.b.c.
Matth.19.d. Marc.10.b. Luc.18.c.	Matth.19.d. Marc.10.b. Luc.18.c.
Ilz regneront en uie par un seul Iesus Christ.	Ilz regneront en vie par un seul Jesus Christ.
Adonc les iustes resplendirõt/ cõme le soleil: au	Adonc les justes resplendiront/ comme le soleil: au
En ce tẽps la sera ton peuple sauue/ tous ceux	En ce temps la sera ton peuple sauve/ tous ceux
qui seront trouuez escritz au liure ⁊c. Dañ.12.a.	qui seront trouvez escritz au livre etc. Dañ.12.a.
me lequel uous est prepare des le commencement	me lequel vous est prepare des le commencement
a manger ⁊c. Adonc aussi dira a ceux qui sont a la	a manger etc. Adonc aussi dira a ceux qui sont a la
senestre: Maudictz departez uous de moy/ au feu	senestre: Maudictz departez vous de moy/ au feu
Et iront ceux icy en torment eternel et les iustes	Et iront ceux icy en torment eternel et les justes
Oeil na point ueu/ ne aureille ouy/ ne est mon	Oeil n’a point veu/ ne aureille ouy/ ne est mon¬
te au coeur dhõme/ quelles sont les choses q̃ dieu	te au coeur d’homme/ quelles sont les choses que dieu
Uoyez) Dañ.12.a. Eccli.24.c. Iehã.4.e.12.d.	Voyez) Dañ.12.a. Eccli.24.c. Jehã.4.e.12.d.
d. Iud.1.a.b. Apoca.2.3.20.21.22.	d. Jud.1.a.b. Apoca.2.3.20.21.22.
¶ Somme des precedens articles.	¶ Somme des precedens articles.
¶ Dieu est manifeste en chair/ iustifie	¶ Dieu est manifeste en chair/ justifie
presche aux Gẽtilz/ creu	presche aux Gentilz/ creu
au monde/ receu	au monde/ receu
¶ Declaration sur les dix cõmande¬	¶ Declaration sur les dix commande¬
mande de bien faire/ et nous deffend	mande de bien faire/ et nous deffend
de mal faire.	de mal faire.
En la montaigne de Sinay/ il dõna a Moyse	En la montaigne de Sinay/ il donna a Moyse
de Dieu. 1.Moyse.31.d.5. Moyse.9.b.	de Dieu. 1.Moyse.31.d.5. Moyse.9.b.
Et lors uous declaira son alliance/ laquelle il	Et lors vous declaira son alliance/ laquelle il
les/ ⁊ les escrit sur deux tables de pierre. 5.Moyse	les/ et les escrit sur deux tables de pierre. 5.Moyse
La loy est saincte/ ⁊ le cõmandemẽt est sainct/ ⁊	La loy est saincte/ et le commandement est sainct/ et
iuste/ ⁊ bon. Rom̃.7.c.	juste/ et bon. Rom̃.7.c.
use legitimement: sachant ce/ que la loy nest point	use legitimement: sachant ce/ que la loy n’est point
Ie nay point congneu peche/ sinon par la loy.	Je n’ay point congneu peche/ sinon par la loy.
Car ie ne congnoissoye point concupiscence: se la	Car je ne congnoissoye point concupiscence: se la
La loy a este nostre instructeur a Christ: affin q̃	La loy a este nostre instructeur a Christ: affin que
La loy est dõnee par Moyse/ grace par Christ.	La loy est donnee par Moyse/ grace par Christ.
Iehan.1.b.	Jehan.1.b.
mediateur iusque a ce que la semence uint/ a laq̃l¬	mediateur jusque a ce que la semence vint/ a laquel¬
¶ Sur le premier cõmandemẽt.	¶ Sur le premier commandement.
¶ De la maieste/ sapience/ ⁊ bonte de Dieu	¶ De la majeste/ sapience/ et bonte de Dieu
auquel seul appartiẽt toute	auquel seul appartient toute
gloire.	gloire.
Escoute Israel/ Leternel nostre Dieu est un	Escoute Israel/ L’eternel nostre Dieu est un
Leternel/ ton dieu est un feu cõsummant/ Dieu	L’eternel/ ton dieu est un feu consummant/ Dieu
Dieu est esperit: ⁊ faut que ceux qui le adorent/	Dieu est esperit: et faut que ceux qui le adorent/
le adorent en esperit ⁊ uerite. Iehan.4.c. 2.Co¬	le adorent en esperit et verite. Jehan.4.c. 2.Co¬
Dieu est charite: et qui demeure en charite il de¬	Dieu est charite: et qui demeure en charite il de¬
Dieu est la lumiere/ ⁊ ny a nulles tenebres en	Dieu est la lumiere/ et n’y a nulles tenebres en
luy. 1.Iehan.1.b.	luy. 1.Jehan.1.b.
dit le Seigneur dieu/ qui est/ ⁊ qui estoit/ et qui est	dit le Seigneur dieu/ qui est/ et qui estoit/ et qui est
Lors Moyse dit a Dieu: Uoicy/ moymesme ay	Lors Moyse dit a Dieu: Voicy/ moymesme ay
este aux enfans Disrael/ ⁊ leur ay dit: Le dieu de	este aux enfans D’israel/ et leur ay dit: Le dieu de
Quel est son nom? Que leur a il dit? Et dieu dit	Quel est son nom? Que leur a il dit? Et dieu dit
ras ainsi aux enfans Disrael: Qui suis/ ma en¬	ras ainsi aux enfans D’israel: Qui suis/ m’a en¬
uoye a uous. Et dieu dit encore a Moyse: Tu di¬	voye a vous. Et dieu dit encore a Moyse: Tu di¬
adire Leternel) Le Dieu de uoz peres/ le Dieu de	adire L’eternel) Le Dieu de voz peres/ le Dieu de
ma enuoye a uous. Ce est mon nom perpetuelle¬	m’a envoye a vous. Ce est mon nom perpetuelle¬
ment/ ⁊ ce est ma cõmemoration en toute genera¬	ment/ et ce est ma commemoration en toute genera¬
Lors dieu parla a Moyse/ ⁊ luy dit: Ie suis Le¬	Lors dieu parla a Moyse/ et luy dit: Je suis L’e¬
cob/ en dieu tout puissant/ ⁊ ne leur ay point dõne	cob/ en dieu tout puissant/ et ne leur ay point donne
a congnoistre mon nom IEOUAH (cestadire	a congnoistre mon nom JEOVAH (c’est adire
Lors Moyse linuocqua. O Eternel Eternel/	Lors Moyse l’invocqua. O Eternel Eternel/
moult debonnaire/ qui garde benignite a milliers/	moult debonnaire/ qui garde benignite a milliers/
qui oste liniquite/ loffense/ ⁊ peche: aussi nul nest	qui oste l’iniquite/ l’offense/ et peche: aussi nul n’est
liniquite des peres sur les enfans des enfans/	l’iniquite des peres sur les enfans des enfans/
Neemie.9.f. Ion.4.a. Ps̈.86.a. Ioel.2.c.	Neemie.9.f. Jon.4.a. Ps̈.86.a. Joel.2.c.
Ie suis grand roy dit Leternel des exercites/	Je suis grand roy dit L’eternel des exercites/
lachie.1.d.	lachie.1.d.
point sinon moy: de dieu iuste/ ⁊ sauueur nen est il	point sinon moy: de dieu juste/ et sauveur n’en est il
point que moy. Isaie.45.d.	point que moy. Isaie.45.d.
nostre dieu? Psalme.17.e.	nostre dieu? Psalme.17.e.
roy sur toute la terre. Psalme.47.b.	roy sur toute la terre. Psalme.47.b.
Qui est ce noble roy/ le fort ⁊ puissãt Eternel.	Qui est ce noble roy/ le fort et puissant Eternel.
Il nya nul sainct/ comme Leternel. Car il ny	Il n’y a nul sainct/ comme L’eternel. Car il n’y
Dieu. 1.Samuel.2.a.	Dieu. 1.Samuel.2.a.
Car Leternel uostre Dieu cest le Dieu des	Car L’eternel vostre Dieu c’est le Dieu des
puissant/ et merueilleux: lequel ne regarde	puissant/ et merveilleux: lequel ne regarde
se.10.d.	se.10.d.
Ce fort/ ce grand/ ce puissant a nom Eternel/	Ce fort/ ce grand/ ce puissant a nom Eternel/
moult grãdz gestes/ duquel les yeux sont ouuers	moult grandz gestes/ duquel les yeux sont ouvers
rẽdre a un chascun selon sa uoye/ ⁊ selon le fruict	rendre a un chascun selon sa voye/ et selon le fruict
de son oeuure. Iere.32.d.	de son oeuvre. Jere.32.d.
des ⁊ merueilleuses: seigñr roy des saĩctz/ tes uoyes	des et merveilleuses: seigneur roy des sainctz/ tes voyes
craindra/ ⁊ ne magnifiera ton nom: Car tu es seul	craindra/ et ne magnifiera ton nom: Car tu es seul
sainct pource uiendront toutes gens/ ⁊ adoreront	sainct pour ce viendront toutes gens/ et adoreront
Apocalip.15.b.	Apocalip.15.b.
seul dieu. Psal.86.b.	seul dieu. Psal.86.b.
Loue soit Leternel/ dieu/ le Dieu Disrael qui	Loue soit L’eternel/ dieu/ le Dieu D’israel qui
Le benoit ⁊ seul prince/ roy/ de ceux qui regnẽt/ ⁊	Le benoit et seul prince/ roy/ de ceux qui regnent/ et
mortalite. 1.Timothee.6.c. Apocalip.19.c.	mortalite. 1.Timothee.6.c. Apocalip.19.c.
Ie suis celuy qui faict toutes choses: iay estẽdu	Je suis celuy qui faict toutes choses: j’ay estendu
Toutes choses qui sont soubz le ciel sont mien-	Toutes choses qui sont soubz le ciel sont mien¬
Ie suis Leternel ⁊ ny a pas dautre/ formant la	Je suis L’eternel et n’y a pas d’autre/ formant la
lumiere ⁊ creant les tenebres/ faisant la prosperi-	lumiere et creant les tenebres/ faisant la prosperi¬
tes ces choses. Isa.45.b.	tes ces choses. Isa.45.b.
ny a nul dieu auec moy. Ie tue ⁊ uiuifie/ ie naure/	n’y a nul dieu avec moy. Je tue et vivifie/ je navre/
et guery: ⁊ ny a nul qui puisse deliurer de mes	et guery: et n’y a nul qui puisse delivrer de mes
Leternel faict mourir ⁊ faict uiure/ il maine a	L’eternel faict mourir et faict vivre/ il maine a
richist/ il abaisse ⁊ haulce/ il eslieue le chetif de la	richist/ il abaisse et haulce/ il eslieve le chetif de la
poudre/ ⁊ le paouure de la fiente pour les faire	poudre/ et le paouvre de la fiente pour les faire
1.Samuel.2.b.	1.Samuel.2.b.
2.Cronicq̃.25.c.	2.Cronicque.25.c.
Ie suis dieu tout puissant: fais que tu chemine	Je suis dieu tout puissant: fais que tu chemine
La terre est au seigneur. Psalme.24.a.	La terre est au seigneur. Psalme.24.a.
me.103.b.	me.103.b.
A toy sont toutes choses/ ⁊ as donne ce q̃ auõs	A toy sont toutes choses/ et as donne ce que avons
Si iay faim/ ie ne le te diray point: car la ron¬	Si j’ay faim/ je ne le te diray point: car la ron¬
Psalme.50.b.	Psalme.50.b.
Dieu qͥ oeuure toutes choses en toꝰ. Phili.2.b.	Dieu qui oeuvre toutes choses en tous. Phili.2.b.
Ephe.4.d.	Ephe.4.d.
pensee ne test cachee. Iob.42.d.	pensee ne t’est cachee. Job.42.d.
Ie suis le premier/ ⁊ suis le dernier/ ⁊ si ny a poĩt	Je suis le premier/ et suis le dernier/ et si n’y a point
calip.1.d.22.c.	calip.1.d.22.c.
Iob.24.a.	Job.24.a.
Celuy qui plante laureille ne orra il pas?	Celuy qui plante l’aureille ne orra il pas?
me.94.b.	me.94.b.
des hommes. 1.des Roix.8.d. 2.Cronicque.6.f.	des hommes. 1.des Roix.8.d. 2.Cronicque.6.f.
Ieremie.17.b.	Jeremie.17.b.
me.44.d.	me.44.d.
Il nest nul bon/ sinon ung seul dieu. Matth.	Il n’est nul bon/ sinon ung seul dieu. Matth.
19.b. Marc.10.b. Luc.18.c.	19.b. Marc.10.b. Luc.18.c.
Romains.3.b.	Romains.3.b.
5.Moyse.23.a. Psalme.92.c.	5.Moyse.23.a. Psalme.92.c.
Ie suis Leternel/ qui ne suis point muable.	Je suis L’eternel/ qui ne suis point muable.
Uers dieu il ny a point de iniquite/ ne de ac¬	Vers dieu il n’y a point de iniquite/ ne de ac¬
nicques.19.c.	nicques.19.c.
Dieu nest pas cõme lhõme/ tellement quil men	Dieu n’est pas comme l’homme/ tellement qu’il men¬
3.Moyse.23.c.	3.Moyse.23.c.
sera auec uous. 1.Corin.13.d.	sera avec vous. 1.Corin.13.d.
Lequel pardonne toutes tes iniquitez/ ⁊ guerit	Lequel pardonne toutes tes iniquitez/ et guerit
Dieu est riche en misericorde. Ephe.2.a.	Dieu est riche en misericorde. Ephe.2.a.
Leternel est ma pierre/ mon boulouart/ ⁊ est ma	L’eternel est ma pierre/ mon boulovart/ et est ma
sauuegarde. Dieu est mon fort/ ie auray esperance	sauvegarde. Dieu est mon fort/ je auray esperance
ma defense/ mon refuge/ mon sauueur tu me deli¬	ma defense/ mon refuge/ mon sauveur tu me deli¬
Certainemẽt iceluy est ma roche/ ⁊ mon salut/	Certainement iceluy est ma roche/ et mon salut/
ma protection/ tellement que ie ne bougeray pas.	ma protection/ tellement que je ne bougeray pas.
forteresse ⁊ mõ esperãce est en dieu. Ps̈.61.b.	forteresse et mon esperance est en dieu. Ps̈.61.b.
estranger auec luy. 5.Moyse.32.b.	estranger avec luy. 5.Moyse.32.b.
Ie suis mesme Leternel de la terre Degipte: Tu	Je suis mesme L’eternel de la terre D’egipte: Tu
a il autre sauueur que moy. Osee.13.b.	a il autre sauveur que moy. Osee.13.b.
Leternel est iceluy dieu/ ⁊ ny a autre que luy seul.	L’eternel est iceluy dieu/ et n’y a autre que luy seul.
5.Moyse.4.f.	5.Moyse.4.f.
Leternel/ est iceluy dieu des cieux en haut: ⁊ sur la	L’eternel/ est iceluy dieu des cieux en haut: et sur la
Ie ne dõneray a personne ma gloire. Isa.48.b.	Je ne donneray a personne ma gloire. Isa.48.b.
Tu adoreras le seigñr ton dieu/ ⁊ a luy seul tu	Tu adoreras le seigneur ton dieu/ et a luy seul tu
A dieu seul sage/ hõneur ⁊ gloire. 1.Timo.1.d.	A dieu seul sage/ honneur et gloire. 1.Timo.1.d.
¶ Exẽples des sainctz/ rendans au seul	¶ Exemples des sainctz/ rendans au seul
Dieu/ gloire ⁊ honneur,	Dieu/ gloire et honneur,
neur de mon Dieu a lhomme/ ⁊ que ie ne adorasse	neur de mon Dieu a l’homme/ et que je ne adorasse
Cornille se iectant aux piedz le adora/ mais	Cornille se jectant aux piedz le adora/ mais
Pierre le leua disãt: Lieue toy debout/ ie suis aussi	Pierre le leva disant: Lieve toy debout/ je suis aussi
Barnabas et Pierre dirent au peuple/ qui leur	Barnabas et Pierre dirent au peuple/ qui leur
ces choses? Nous sommes aussi subiectz a pareilz	ces choses? Nous sommes aussi subjectz a pareilz
maux comme uous/ annonceans que uous uous	maux comme vous/ annonceans que vous vous
a faict le ciel/ ⁊ la terre/ ⁊ la mer/ ⁊ toutes choses qͥ	a faict le ciel/ et la terre/ et la mer/ et toutes choses qui
Hõmes Israelites/ pourquoy uous esmerueillez	Hommes Israelites/ pourquoy vous esmerveillez
uous de ce: ou pourquoy nous regardez uous/ cõ¬	vous de ce: ou pourquoy nous regardez vous/ com¬
cestuy cheminast? Le Dieu de Abraam/ et Isaac/	cestuy cheminast? Le Dieu de Abraam/ et Isaac/
Actes.3.b.	Actes.3.b.
Lange dit a sainct Iehan qui le uouloit adorer)	L’ange dit a sainct Jehan qui le vouloit adorer)
toy/ ⁊ tes freres ayãs tesmoignage de Iesus. Adore	toy/ et tes freres ayans tesmoignage de Jesus. Adore
¶ Item uoyez a ce/ au cõmencement de lexpo¬	¶ Item voyez a ce/ au commencement de l’expo¬
sitiõ tant de loraison dominicale que des arti¬	sition tant de l’oraison dominicale que des arti¬
¶ Sur le second cõmandement.	¶ Sur le second commandement.
Ie suis Leternel/ cest mon nom: ie ne donneray	Je suis L’eternel/ c’est mon nom: je ne donneray
a aucun ma gloire/ ne ma louenge aux images.	a aucun ma gloire/ ne ma louenge aux images.
Leternel uostre dieu a parle du millieu du feu/	L’eternel vostre dieu a parle du millieu du feu/
uez ueu la semblance: fors que la uoix. Et uoꝰ an¬	vez veu la semblance: fors que la voix. Et vous an¬
nõcea son alliãce/ laquelle uous cõmanda a faire:	noncea son alliance/ laquelle vous commanda a faire:
bles de pierre. Et me cõmanda Leternel en ce tẽps	bles de pierre. Et me commanda L’eternel en ce temps
affin que uous les faciez en la terre/ a laq̃lle uous	affin que vous les faciez en la terre/ a laquelle vous
passez pour la posseder. Et prenez garde songneu¬	passez pour la posseder. Et prenez garde songneu¬
blance au iour q̃ Leternel/ uostre dieu parla a uoꝰ	blance au jour que L’eternel/ vostre dieu parla a vous
rõpus/ ⁊ faciez pour uous tailleure/ similitude de	rompus/ et faciez pour vous tailleure/ similitude de
image quelconque/ soit espece de masle/ ou de fe¬	image quelconque/ soit espece de masle/ ou de fe¬
Prenez garde a uous: affin q̃ ne oubliez lallian	Prenez garde a vous: affin que ne oubliez l’allian¬
⁊ que ne uous faciez image taillee de tout ce q̃ Le¬	et que ne vous faciez image taillee de tout ce que L’e¬
ternel uostre dieu uous a defẽdu: car Leternel ton	ternel vostre dieu vous a defendu: car L’eternel ton
tu auras engendre des enfans/ ⁊ enfans de tes en¬	tu auras engendre des enfans/ et enfans de tes en¬
uous corrõpez ⁊ faictes images taillees/ similitu¬	vous corrompez et faictes images taillees/ similitu¬
de de choses quelcõques/ ⁊ faciez mal deuant ton	de de choses quelconques/ et faciez mal devant ton
ie appelle auiourdhuy en tesmoignage le ciel ⁊ la	je appelle aujourdhuy en tesmoignage le ciel et la
la terre/ en laquelle uous allez oultre le Iordain	la terre/ en laquelle vous allez oultre le Jordain
pour la posseder: et ny prolongerez uoz iours/	pour la posseder: et n’y prolongerez voz jours/
se.4.d.	se.4.d.
blance mettrez uoꝰ pour luy? louurier ne fond il	blance mettrez vous pour luy? l’ouvrier ne fond il
point limage? lorfebure/ ne le figure il point en	point l’image? l’orfebvre/ ne le figure il point en
uous congnoissance? lauez uous ouy? Le uous	vous congnoissance? l’avez vous ouy? Le vous
mauez uous faict semblable ⁊ accompare/ dit le	m’avez vous faict semblable et accompare/ dit le
Sainct. Esleuez uoz yeux en haut/ ⁊ regardez qui	Sainct. Eslevez voz yeux en haut/ et regardez qui
A quoy mauez uous figure/ ⁊ contrefaict: accõ	A quoy m’avez vous figure/ et contrefaict: accom¬
et poisez largent aux balances. Uous louez lor¬	et poisez l’argent aux balances. Vous louez l’or¬
febure/ et faict ce dieu. Puis se prosternent et la¬	febvre/ et faict ce dieu. Puis se prosternent et l’a¬
tent/ et le posent en son lieu. Lors est arreste	tent/ et le posent en son lieu. Lors est arreste
luy/ il ne respond rien/ il ne deliure point de tri¬	luy/ il ne respond rien/ il ne delivre point de tri¬
bulation. Uous souuienne de ce/ et uous fortifiez.	bulation. Vous souvienne de ce/ et vous fortifiez.
uenance du temps passe: car moymesme ie suis	venance du temps passe: car moymesme je suis
Isaie.46.b.c.	Isaie.46.b.c.
Ne uous retournez point aux idoles/ ⁊ ne uous	Ne vous retournez point aux idoles/ et ne vous
2.Moyse.34.c.	2.Moyse.34.c.
rez point idoles/ ne images taillees/ ne esleuerez	rez point idoles/ ne images taillees/ ne esleverez
nulz ueaux/ ⁊ ne colloquerez nulle pierre notable	nulz veaux/ et ne colloquerez nulle pierre notable
uostre dieu. 3.Moyse.26.a.	vostre dieu. 3.Moyse.26.a.
seduyt/ et que uous ne uous retirez du seigneur	seduyt/ et que vous ne vous retirez du seigneur
dieu/ et seruiez aux dieux estranges et les adoriez.	dieu/ et serviez aux dieux estranges et les adoriez.
Il nya pas didole en Iacob/ et simulachre nest	Il n’y a pas d’idole en Jacob/ et simulachre n’est
4.Moyse.23.c.d.	4.Moyse.23.c.d.
Maudict soit lhomme qui faict image de tail¬	Maudict soit l’homme qui faict image de tail¬
gneur/ loeuure des mains des ouuriers/ et qui la	gneur/ l’oeuvre des mains des ouvriers/ et qui la
dira. Ainsi soit il. 5.Moyse.27.c.	dira. Ainsi soit il. 5.Moyse.27.c.
Et si au millieu de toy se lieue un prophete ou	Et si au millieu de toy se lieve un prophete ou
dise signe et chose merueilleuse/ et que ce quil a	dise signe et chose merveilleuse/ et que ce qu’il a
les dieux q̃ tu ne congnois point ⁊ seruons a eux/	les dieux que tu ne congnois point et servons a eux/
tu ne escouteras point les parolles de ce prophete	tu ne escouteras point les parolles de ce prophete
uous tente pour scauoir si manifestement uous le	vous tente pour scavoir si manifestement vous le
stre ame ⁊c. 5.Moyse.13.a.	stre ame etc. 5.Moyse.13.a.
Les idoles des gẽs sont or ⁊ argent/ oeuures des	Les idoles des gens sont or et argent/ oeuvres des
Car loeuure de la main de louurier a coppe le	Car l’oeuvre de la main de l’ouvrier a coppe le
gẽt/ ⁊ la attache de cloux/ affin qͥl ne se desioingne	gent/ et l’a attache de cloux/ affin qu’il ne se desjoingne
point ⁊c. Toutes ces choses sõt oeuure douuriers	point etc. Toutes ces choses sont oeuvre d’ouvriers
roy perpetuel. Iere.10.a.b.	roy perpetuel. Jere.10.a.b.
retire de la terre Degypte. Et en a mis un en Be¬	retire de la terre D’egypte. Et en a mis un en Be¬
tel/ ⁊ lautre en Dan. Et ceste chose a este a peche.	tel/ et l’autre en Dan. Et ceste chose a este a peche.
Abbatez leurs autelz/ ⁊ brisez leurs statues/ et	Abbatez leurs autelz/ et brisez leurs statues/ et
peuple saĩct/ au seigneur ton dieu. 5.Moyse.7.a.	peuple sainct/ au seigneur ton dieu. 5.Moyse.7.a.
12.a. 2.Moyse.34.b.	12.a. 2.Moyse.34.b.
ont mue la gloire de dieu immortel/ en similitude	ont mue la gloire de dieu immortel/ en similitude
gloire diceluy en mensonge/ ⁊ ont faict reuerence ⁊	gloire d’iceluy en mensonge/ et ont faict reverence et
seruice plus a la chose cree/ que au createur/ lequel	service plus a la chose cree/ que au createur/ lequel
Ne soyez point idolatres/ ainsi que aucuns de	Ne soyez point idolatres/ ainsi que aucuns de
manger ⁊ pour boire/ ⁊ se sont leuez pour iouer.	manger et pour boire/ et se sont levez pour jouer.
1.Corin.10.b. 2.Moyse.32.b.	1.Corin.10.b. 2.Moyse.32.b.
Enfans donnez uous garde des images. 1.Ie¬	Enfans donnez vous garde des images. 1.Je¬
Nous scauons que limage nest rien au monde/	Nous scavons que l’image n’est rien au monde/
⁊ que nul nest Dieu sinõ ung seul. Car ia soit que	et que nul n’est Dieu sinon ung seul. Car ja soit que
en terre (cõme ilz sont plusieurs dieux ⁊ plusieurs	en terre (comme ilz sont plusieurs dieux et plusieurs
pere/ duquel sont toutes choses ⁊ nous en luy. Et	pere/ duquel sont toutes choses et nous en luy. Et
un Seigñr Iesus Christ/ par lequel toutes choses	un Seigneur Jesus Christ/ par lequel toutes choses
Uoyez) 5.Moyse.4.c.5.a.7.a.12.a. Isa.2.40.42.	Voyez) 5.Moyse.4.c.5.a.7.a.12.a. Isa.2.40.42.
ruch.6. Sapien.13.14.15.16.	ruch.6. Sapien.13.14.15.16.
¶ Item de ceux qui ont abbatu ⁊ oste toutes	¶ Item de ceux qui ont abbatu et oste toutes
Iosaphat. 2.Croniq.9.a. Et Iosias. 2.Roix	Josaphat. 2.Croniq.9.a. Et Josias. 2.Roix
oraison.	oraison.
¶ Sur le .iii. cõmandement.	¶ Sur le .iii. commandement.
dieu en uain ⁊ sans cause.	dieu en vain et sans cause.
sanctifie entre les enfans Disrael. Ie suis Leter¬	sanctifie entre les enfans D’israel. Je suis L’eter¬
nel qui uous sanctifie. 3.Moyse.22.d.	nel qui vous sanctifie. 3.Moyse.22.d.
Tu ne iureras point par mon nom en mentant/	Tu ne jureras point par mon nom en mentant/
3.Moyse.19 c.	3.Moyse.19 c.
Ne iurez au nom de leurs dieux/ et ne seruez a	Ne jurez au nom de leurs dieux/ et ne servez a
dieu/ ce q̃ auez faict iusque a ce iour. Iosue.23.b.	dieu/ ce que avez faict jusque a ce jour. Josue.23.b.
dieux/ ⁊ ne sera poĩt ouy en ta bouche. 2.Moy.23.b	dieux/ et ne sera point ouy en ta bouche. 2.Moy.23.b
Ne iurez nullemẽt/ ne par le ciel/ car cest le thro	Ne jurez nullement/ ne par le ciel/ car c’est le thro¬
de ses piedz: ne par Hierusalem: car cest la cite du	de ses piedz: ne par Hierusalem: car c’est la cite du
peux faire un cheueu blãc ou noir. Mais soit ur̃e	peux faire un cheveu blanc ou noir. Mais soit vostre
parolle/ Ouy/ ouy: Non/ non. Car ce qͥ est adiouste	parolle/ Ouy/ ouy: Non/ non. Car ce qui est adjouste
Dieu certes est ueritable/ que nostre parolle qui	Dieu certes est veritable/ que nostre parolle qui
le filz de dieu Iesus Christ: qui entre uoꝰ par nous	le filz de dieu Jesus Christ: qui entre vous par nous
a este presche/ par moy ⁊ Siluain ⁊ Timothee: na	a este presche/ par moy et Silvain et Timothee: n’a
toutes les ꝓmesses de dieu/ sont par celuy Ouy: ⁊	toutes les promesses de dieu/ sont par celuy Ouy: et
rinthiens.1.d.	rinthiens.1.d.
Uostre parolle soit tousiours cõfite en sel auec	Vostre parolle soit tousjours confite en sel avec
Si aucun parle/ quil parle comme parolles de	Si aucun parle/ qu’il parle comme parolles de
¶ Du iurement licite/ concernant lhonneur	¶ Du jurement licite/ concernant l’honneur
de Dieu/ et ledification du prochain.	de Dieu/ et l’edification du prochain.
fin de tout leur different/ pour cõfirmation est le	fin de tout leur different/ pour confirmation est le
Tu seras a luy adherent/ ⁊ iureras par sõ nom.	Tu seras a luy adherent/ et jureras par son nom.
5.Moyse.10.d.6.c.	5.Moyse.10.d.6.c.
Tous ceux qͥ iurent en luy serõt louez. Ps̈.63.c	Tous ceux qui jurent en luy seront louez. Ps̈.63.c
tira hors de ma bouche/ ⁊ ne retournera poĩt. Car	tira hors de ma bouche/ et ne retournera point. Car
tout genouil se ployera deuãt moy: ⁊ toute lãgue	tout genouil se ployera devant moy: et toute langue
Dieu auq̃l ie sers en mon esperit en leuãgile de	Dieu auquel je sers en mon esperit en l’evangile de
Uoyez exẽples) Du iuremẽt faict en iugemẽt.	Voyez exemples) Du jurement faict en jugement.
2.Moy.22.a. De Abimelech ⁊ Isaac. 1.Moy.26.g.	2.Moy.22.a. De Abimelech et Isaac. 1.Moy.26.g.
g. De Iosue auec les princes. Iosue.9.d. Des Is¬	g. De Josue avec les princes. Josue.9.d. Des Is¬
d.2. Samuel.19.d. 1.Roys.1.b.c.d.2.b. De Paul.	d.2. Samuel.19.d. 1.Roys.1.b.c.d.2.b. De Paul.
2.Corin.1.d.	2.Corin.1.d.
¶ Du iour du sabbath ou repos.	¶ Du jour du sabbath ou repos.
auoit faicte/ ⁊ beneit le septiesme iour ⁊ le sãctifia.	avoit faicte/ et beneit le septiesme jour et le sanctifia.
1.Moy.2.a. 2.Moy.20.b. Heb.4.a.b.	1.Moy.2.a. 2.Moy.20.b. Heb.4.a.b.
cest le signe entre moy ⁊ uous/ en uoz generatiõs:	c’est le signe entre moy et vous/ en voz generations:
sãctifie. Gardez mõ sabbath/ car il est saĩct enuers	sanctifie. Gardez mon sabbath/ car il est sainct envers
uoꝰ. Cestuy qͥ le aura pollut/ qͥl meure de mort ⁊c.	vous. Cestuy qui le aura pollut/ qu’il meure de mort etc.
⁊ le signe perpetuel. 2.Moy.31.c.d. Ezech.20.b.	et le signe perpetuel. 2.Moy.31.c.d. Ezech.20.b.
iour tu te reposeras: affin que ton boeuf ⁊ ton asne	jour tu te reposeras: affin que ton boeuf et ton asne
cesse/ ⁊ que le filz de ta seruante ⁊ lestrangier ayent	cesse/ et que le filz de ta servante et l’estrangier ayent
Affin que ton seruiteur et ta seruante reposent	Affin que ton serviteur et ta servante reposent
Ie ne souffriray plus uostre prime lune/ ne le	Je ne souffriray plus vostre prime lune/ ne le
sabbath ne les autres festes. Uoz congregations	sabbath ne les autres festes. Voz congregations
des/ ⁊ uoz solẽnitez: icelles me sont en charge/ ⁊ ay	des/ et voz solennitez: icelles me sont en charge/ et ay
¶ De la deliurance du sabbath	¶ De la delivrance du sabbath
charnel ⁊ figuratif.	charnel et figuratif.
en partie du iour de la feste/ ou du nouueau moys/	en partie du jour de la feste/ ou du nouveau moys/
a aduenir/ le corps certes de Christ. Colos.2.f.	a advenir/ le corps certes de Christ. Colos.2.f.
Uoꝰ obseruez les iours/ ⁊ les moys/ ⁊ les tẽps/	Vous observez les jours/ et les moys/ et les temps/
Certes se uous entendiez que cest: Ie ueux mise	Certes se vous entendiez que c’est: Je veux mise¬
dẽne les innocens. Car le filz de lhõme est Seigñr	demne les innocens. Car le filz de l’homme est Seigneur
aussi du sabbath ⁊c. Il est donc licite de bien fair	aussi du sabbath etc. Il est donc licite de bien fair
Le sabbath est faict pour lhomme/ ⁊ non point	Le sabbath est faict pour l’homme/ et non point
¶ Du sabbath spirituel ⁊ perpetuel.	¶ Du sabbath spirituel et perpetuel.
Lors sera perpetuel moys/ ⁊ perpetuel sabbath.	Lors sera perpetuel moys/ et perpetuel sabbath.
Nous qui auons creu: entrerõs au repos/ cõme	Nous qui avons creu: entrerons au repos/ comme
affin que aucun ne chee en semblable exemple din	affin que aucun ne chee en semblable exemple d’in¬
credulite ⁊c. Hebr.4.a.b.c.	credulite etc. Hebr.4.a.b.c.
se.16.e.20.b.31.a.34.c.35.a. 3.Moyse.19.a.f.23.a.	se.16.e.20.b.31.a.34.c.35.a. 3.Moyse.19.a.f.23.a.
2.Esdr.13.b. 2.Moy.16.f. 4.Moy.15.d. Luc.3.c.	2.Esdr.13.b. 2.Moy.16.f. 4.Moy.15.d. Luc.3.c.
6.a. 1.Corin.16.a. Iehã.5.c.d.e.7.c. Luc.13.c.	6.a. 1.Corin.16.a. Jehã.5.c.d.e.7.c. Luc.13.c.
Tu laboureras par six iours/ ⁊ feras toutes tes	Tu laboureras par six jours/ et feras toutes tes
En la sueur de tõ uisage tu mãgeras ton pain:	En la sueur de ton visage tu mangeras ton pain:
iusque a ce que tu retourne en la terre/ de laquelle	jusque a ce que tu retourne en la terre/ de laquelle
tourneras. 1.Moyse.3.c.	tourneras. 1.Moyse.3.c.
uoller. Iob.5.a.	voller. Job.5.a.
Qui laboure son chãp/ il sera rassasie de pains:	Qui laboure son champ/ il sera rassasie de pains:
Quãd aĩsi tu mãgeras le labeur de tes mains/	Quand ainsi tu mangeras le labeur de tes mains/
Celuy qui desroboit/ maintenãt qͥl ne desrobbe	Celuy qui desroboit/ maintenant qu’il ne desrobbe
plus: mais plus tost quil labeure en oeuurant de	plus: mais plus tost qu’il labeure en oeuvrant de
niquer a celuy qui a disette. Ephe.4.f.	niquer a celuy qui a disette. Ephe.4.f.
1.Corinthiens.4.c.	1.Corinthiens.4.c.
Uous scauez cõmẽt il faut q̃ uous nous ensuy¬	Vous scavez comment il faut que vous nous ensuy¬
⁊ ne auons point mãge le pain daucun pour neãt.	et ne avons point mange le pain d’aucun pour neant.
affin q̃ ne greuissions aucuns dentre uous. Non	affin que ne grevissions aucuns d’entre vous. Non
pas que nous ne ayõs eu la puissance: mais affin	pas que nous ne ayons eu la puissance: mais affin
pour nous ensuyure. Car aussi quand nous estiõs	pour nous ensuyvre. Car aussi quand nous estions
se aucun ne ueut ouurer quil ne mange point.	se aucun ne veut ouvrer qu’il ne mange point.
2.Thessalo.3.b.c. 1.Thessa.4.c.	2.Thessalo.3.b.c. 1.Thessa.4.c.
a ceux qui sont auec moy/ ses mains cy les ont ad¬	a ceux qui sont avec moy/ ses mains cy les ont ad¬
ceux qui labourent ainsi il faut quilz aydent les	ceux qui labourent ainsi il faut qu’ilz aydent les
foibles ⁊ ayent memoire de la parolle de nostre sei¬	foibles et ayent memoire de la parolle de nostre sei¬
reuse de donner que de prendre. Act̃.20.g.	reuse de donner que de prendre. Act̃.20.g.
maniere/ affin que tu soye sage. Prouer.6.a.	maniere/ affin que tu soye sage. Prover.6.a.
Ne laboure pas pour estre riche: deporte toy de	Ne laboure pas pour estre riche: deporte toy de
Uoyez) Prouer.6.10.13.18.20.21.24.28. Eccłe.11.	Voyez) Prover.6.10.13.18.20.21.24.28. Eccłe.11.
¶ Sur le .u. cõmandement.	¶ Sur le .v. commandement.
¶ De hõnorer pere ⁊ mere: ⁊	¶ De honnorer pere et mere: et
lieu diceux.	lieu d’iceux.
dieu le ta cõmande/ affin que tes iours soyẽt prolõ	dieu le ta commande/ affin que tes jours soyent prolon¬
gez/ ⁊ affin quil te soit bien sur la terre laq̃lle Le¬	gez/ et affin qu’il te soit bien sur la terre laquelle L’e¬
Celuy qui craint le Seigneur faict honneur a	Celuy qui craint le Seigneur faict honneur a
me aux seigneurs/ en oeuure/ ⁊ en parolle/ ⁊ en tou	me aux seigneurs/ en oeuvre/ et en parolle/ et en tou¬
te patience. Hõnore ton pere/ affin que benediction	te patience. Honnore ton pere/ affin que benediction
Un chascun craindra son pere et sa mere. 3.	Un chascun craindra son pere et sa mere. 3.
Hõnore pere ⁊ mere. Matth.15.a. Marc.7.b.	Honnore pere et mere. Matth.15.a. Marc.7.b.
Maudit soit celuy qui ne honnore son pere ⁊ sa	Maudit soit celuy qui ne honnore son pere et sa
Enfans obeissez a uoz peres ⁊ a uoz meres en	Enfans obeissez a voz peres et a voz meres en
ta mere (lequel est le premier cõmandemẽt en pro¬	ta mere (lequel est le premier commandement en pro¬
messe) affin quil te soit bien/ ⁊ que tu soye de lon¬	messe) affin qu’il te soit bien/ et que tu soye de lon¬
Qui donne trauail a son pere/ ⁊ deboute sa me	Qui donne travail a son pere/ et deboute sa me¬
Qui frappe sõ pere ou sa mere soit mis a mort.	Qui frappe son pere ou sa mere soit mis a mort.
2.Moyse.21.b.	2.Moyse.21.b.
2.Moy.21.b.3. Moyse.20.a.b. 5.Moy.21.d.	2.Moy.21.b.3. Moyse.20.a.b. 5.Moy.21.d.
ra esteinte au millieu des tenebres. Prouer.20.c.	ra esteinte au millieu des tenebres. Prover.20.c.
Les corbeaux creueront aupres du fleuue/ ⁊ les	Les corbeaux creveront aupres du fleuve/ et les
contemne son pere/ ⁊ contẽne le cõmandement de	contemne son pere/ et contemne le commandement de
Escoute ton pere qui ta engendre/ ⁊ ne mesprise	Escoute ton pere qui t’a engendre/ et ne mesprise
ta mere/ pource quelle est ancienne. Prouer.23.c.	ta mere/ pour ce qu’elle est ancienne. Prover.23.c.
peche: cestuy est le cõpaignon de lhomicide. Pro¬	peche: cestuy est le compaignon de l’homicide. Pro¬
Uoyez) 3. Moy.20.a. 5.Moy.21.a. Tob.4.a.	Voyez) 3. Moy.20.a. 5.Moy.21.a. Tob.4.a.
Ecclesiastique.3. ⁊. 7. Exẽples de Isaac. 1.Moy¬	Ecclesiastique.3. et. 7. Exemples de Isaac. 1.Moy¬
bie.5.a. De Iesus Christ. Luc.2.g. Et aux Phi	bie.5.a. De Jesus Christ. Luc.2.g. Et aux Phi¬
¶ Comment pour lamour du pere on ne	¶ Comment pour l’amour du pere on ne
doit desobeir a Dieu/ le sou¬	doit desobeir a Dieu/ le sou¬
Ne pensez point que ie soye uenu mettre paix	Ne pensez point que je soye venu mettre paix
mais le glaiue. Car ie suis uenu separer lhomme	mais le glaive. Car je suis venu separer l’homme
alencõtre de son pere ⁊ la fille alencõtre de sa me¬	a l’encontre de son pere et la fille a l’encontre de sa me¬
ennemis de lhõme serõt ceux de sa maisõ ⁊c. Qui	ennemis de l’homme seront ceux de sa maison etc. Qui
digne de moy. Matth.10.d.	digne de moy. Matth.10.d.
Et tout hõme qui aura delaisse maison/ ou fre¬	Et tout homme qui aura delaisse maison/ ou fre¬
fans/ ou champ/ pour mon nom: il en receura cent	fans/ ou champ/ pour mon nom: il en recevra cent
Ne soyez pas cõme uoz peres cõtre lesquelz les	Ne soyez pas comme voz peres contre lesquelz les
premiers ꝓphetes crioyẽt ⁊c. zacharie.1.a. Psal¬	premiers prophetes crioyent etc. zacharie.1.a. Psal¬
Ne uueillez cheminer aux cõmandemẽs de uoz	Ne vueillez cheminer aux commandemens de voz
point souillez en leurs images. Ie suis le seigneur	point souillez en leurs images. Je suis le seigneur
Dieu uostre Dieu. Cheminez en mes commande¬	Dieu vostre Dieu. Cheminez en mes commande¬
chiel.20.c.	chiel.20.c.
quelz se sont retirez du seigneur le Dieu de uoz pe¬	quelz se sont retirez du seigneur le Dieu de voz pe¬
res ⁊ les a mis en desolation comme uous uoyez.	res et les a mis en desolation comme vous voyez.
cõme uoz peres. 2.Cronicques.30.b.	comme voz peres. 2.Cronicques.30.b.
lhõneur ⁊ obedience deue aux princes	l’honneur et obedience deue aux princes
et gouuerneurs: lesquelz doib¬	et gouverneurs: lesquelz doib¬
au peuple.	au peuple.
Tu ne maudiras point les dieux (cest adire iu¬	Tu ne maudiras point les dieux (c’est a dire ju¬
ges) ⁊ ne blasmeras point le prince de ton peuple.	ges) et ne blasmeras point le prince de ton peuple.
Baillez a Cesar/ ce qui appartient a Cesar.	Baillez a Cesar/ ce qui appartient a Cesar.
Toute ame soit subiecte aux superiores puis¬	Toute ame soit subjecte aux superiores puis¬
sances. Car il ny a point de puissãce/ sinõ de dieu.	sances. Car il n’y a point de puissance/ sinon de dieu.
dieu. Parquoy qui resiste a la puissance: il resiste	dieu. Parquoy qui resiste a la puissance: il resiste
rent dãnation a eux mesmes. Elle ne porte point	rent damnation a eux mesmes. Elle ne porte point
le glaiue sans cause: car elle est seruante a Dieu/	le glaive sans cause: car elle est servante a Dieu/
Pour ceste cause certes uous payez les tributz: car	Pour ceste cause certes vous payez les tributz: car
Rendez donc a tous les choses deues: a qui tribut/	Rendez donc a tous les choses deues: a qui tribut/
le tribut: a qui peage/ le peage: a qui crainte/ la	le tribut: a qui peage/ le peage: a qui crainte/ la
Soyez subiectz a toute humaine creature: pour	Soyez subjectz a toute humaine creature: pour
Ducz/ cõme aux enuoyez de par luy pour faire uẽ¬	Ducz/ comme aux envoyez de par luy pour faire ven¬
geance des malfaicteurs/ et pour la louenge des	geance des malfaicteurs/ et pour la louenge des
Admonneste iceux destre subiectz aux princes ⁊	Admonneste iceux d’estre subjectz aux princes et
Obeissez a uoz superieurs: et soyez subiectz a	Obeissez a voz superieurs: et soyez subjectz a
eux (car ilz sont ueillans: cõme ceux qui rendront	eux (car ilz sont veillans: comme ceux qui rendront
ment et non point en gemissant: car ce ne uous est	ment et non point en gemissant: car ce ne vous est
¶ Item de lobeissance des seruiteurs uers	¶ Item de l’obeissance des serviteurs vers
leurs seigneurs.	leurs seigneurs.
seigneurs charnelz/ ne seruant point a loeil/ cõme	seigneurs charnelz/ ne servant point a l’oeil/ comme
craignans dieu. Quelque chose que uous faictes/	craignans dieu. Quelque chose que vous faictes/
faictes la de couraige: ainsi cõme a dieu/ non pas	faictes la de couraige: ainsi comme a dieu/ non pas
nostre seigñr/ la retribution de lheritage: car uous	nostre seigneur/ la retribution de l’heritage: car vous
Quiconques sont soubz la subiection de serui¬	Quiconques sont soubz la subjection de servi¬
tude/ quilz estiment leurs seigneurs dignes de tout	tude/ qu’ilz estiment leurs seigneurs dignes de tout
doctrine ne soit blasmee. Et ceulx qui ont seigneͬs	doctrine ne soit blasmee. Et ceulx qui ont seigneurs
sont freres: mais plus tost quilz les seruent/ pour	sont freres: mais plus tost qu’ilz les servent/ pour
ce quilz sont fideles et aymez/ lesquelz sont par¬	ce qu’ilz sont fideles et aymez/ lesquelz sont par¬
neste. 1.Timothee.6.a.	neste. 1.Timothee.6.a.
leurs seigneurs/ plaisans en toutes choses: non cõ	leurs seigneurs/ plaisans en toutes choses: non con¬
tredisans/ non deceuans: mais mõstrans toute bõ	tredisans/ non decevans: mais monstrans toute bon¬
ctrine de dieu nostre sauueur. Tite.2.b.	ctrine de dieu nostre sauveur. Tite.2.b.
a uoz seigneurs: non seulement aux bons et mo¬	a voz seigneurs: non seulement aux bons et mo¬
destes/ mais aux difficiles. 1.Pierre.2.c.	destes/ mais aux difficiles. 1.Pierre.2.c.
Fays reuerence a la uieillesse/ ⁊ hõnore la per¬	Fays reverence a la vieillesse/ et honnore la per¬
Moyse.19.g.	Moyse.19.g.
Sẽblablement uous ieunes soyez subiectz aux	Semblablement vous jeunes soyez subjectz aux
autres. 1.Pierre.5.b.	autres. 1.Pierre.5.b.
le cõme pere: les ieunes/ comme freres: les uieilles/	le comme pere: les jeunes/ comme freres: les vieilles/
cõme meres: les ieunes filles/ cõme soeurs: en tou¬	comme meres: les jeunes filles/ comme soeurs: en tou¬
¶ Contre lhonneur ⁊ la gloire de dieu/	¶ Contre l’honneur et la gloire de dieu/
Il uaut mieux obeir a dieu/ que aux hommes.	Il vaut mieux obeir a dieu/ que aux hommes.
Actes.4.d.5.e.	Actes.4.d.5.e.
femmes. Exode.1.c.	femmes. Exode.1.c.
¶ De homicide/ ⁊ malueillance.	¶ De homicide/ et malveillance.
A moy est la uengeance. 5.Moyse.32.e. Eccle	A moy est la vengeance. 5.Moyse.32.e. Eccle¬
Qui respandera le sang de lhõme/ son sãg luy	Qui respandera le sang de l’homme/ son sang luy
1.Moyse.9.a.	1.Moyse.9.a.
Ne quiers point uengeance/ ⁊ naye recordation	Ne quiers point vengeance/ et n’aye recordation
Ne dis point/ ie rendray le mal: mais attens le	Ne dis point/ je rendray le mal: mais attens le
Tu ne seras point homicide. Matthieu.19.b.	Tu ne seras point homicide. Matthieu.19.b.
5.Moyse.5.a. Romains.13.c.	5.Moyse.5.a. Romains.13.c.
mis a mort. 3.Moyse.24.c. 2.Moyse.21.b.	mis a mort. 3.Moyse.24.c. 2.Moyse.21.b.
des tesmoĩgz/ le meurtrier sera occis. 3.Moy.35.d.	des tesmoingz/ le meurtrier sera occis. 3.Moy.35.d.
Remetz ton glaiue en son lieu. Car tous ceux	Remetz ton glaive en son lieu. Car tous ceux
thieu.26.e. Apocalip.13.c.	thieu.26.e. Apocalip.13.c.
du tout en abhominatiõ. Ascauoir la langue mẽ¬	du tout en abhomination. Ascavoir la langue men¬
teresse: les mains qui respandent le sang des inno¬	teresse: les mains qui respandent le sang des inno¬
piedz qͥ courrẽt apres les maux/ le faux tesmoing/	piedz qui courrent apres les maux/ le faux tesmoing/
Tu nauras point hayne/ en ton coeur cõtre ton	Tu n’auras point hayne/ en ton coeur contre ton
prochain. 3.Moyse.19.d.	prochain. 3.Moyse.19.d.
pechez. Prouerbes.10.b.	pechez. Proverbes.10.b.
eis mains du cruel messagier. Si tu rendz le mal	eis mains du cruel messagier. Si tu rendz le mal
pour mal: le mal ne se partira point de sa maison.	pour mal: le mal ne se partira point de sa maison.
Uous auez ouy qͥl a este dit aux anciẽs: Tu ne	Vous avez ouy qu’il a este dit aux anciens: Tu ne
de iugement. Mais moy ie uous dy que tout hom	de jugement. Mais moy je vous dy que tout hom¬
me qui se courrouce a son frere: sera coupable de iu	me qui se courrouce a son frere: sera coupable de ju¬
il sera coupable de cõcile. Et qͥcõque aura dit/ fol:	il sera coupable de concile. Et quiconque aura dit/ fol:
Quicõque hayt son frere/ est homicide: et uous	Quiconque hayt son frere/ est homicide: et vous
scauez que tout homicide na point la uie eternelle	scavez que tout homicide n’a point la vie eternelle
Ne resistez poĩt au mal/ mais se aucun te frappe	Ne resistez point au mal/ mais se aucun te frappe
ueut ꝓceder en iugemẽt ꝯtre toy/ ⁊ te oster ta robbe:	veut proceder en jugement contre toy/ et te oster ta robbe:
laisse luy aussi ton manteau. Et quicõque te ueut	laisse luy aussi ton manteau. Et quiconque te veut
mille ⁊c. Aymez uoz ennemis/ faictes bien a ceux	mille etc. Aymez voz ennemis/ faictes bien a ceux
cutent/ ⁊ qui faucemẽt imposent crimes: affin que	cutent/ et qui faucement imposent crimes: affin que
uous soyez filz de uostre pere qui est eis cieux/ leq̃l	vous soyez filz de vostre pere qui est eis cieux/ lequel
uais/ ⁊ enuoye pluye sur les iustes et iniustes ⁊c.	vais/ et envoye pluye sur les justes et injustes etc.
Gardez que aucun ne rẽde mal pour mal: mais	Gardez que aucun ne rende mal pour mal: mais
ensuyuez tousiours ce qui est bon les uns uers les	ensuyvez tousjours ce qui est bon les uns vers les
Ne uous uengez point mes tresaymez: mais dõ	Ne vous vengez point mes tres aymez: mais don¬
ce: ⁊ ie la rendray/ dit le Seigneur. Mais se tõ en¬	ce: et je la rendray/ dit le Seigneur. Mais se ton en¬
nemy a fain: dõne luy a mãger: Se il a soif: donne	nemy a fain: donne luy a manger: Se il a soif: donne
charbons de feu sur la teste. Ne soye point uaincu	charbons de feu sur la teste. Ne soye point vaincu
Courroucez uous: ⁊ ne pechez point. Le soleil	Courroucez vous: et ne pechez point. Le soleil
ne se couche point sur uostre courroux/ ne donnez	ne se couche point sur vostre courroux/ ne donnez
roux/ ⁊ ire/ ⁊ crierie/ ⁊ blasme soyent ostez de uous	roux/ et ire/ et crierie/ et blasme soyent ostez de vous
¶ De pugnir appartiẽt seulemẽt aux iuges	¶ De pugnir appartient seulement aux juges
comme lieutenans de dieu/ qui par lordon¬	comme lieutenans de dieu/ qui par l’ordon¬
amour de iustice ⁊ non par courroux/ comme	amour de justice et non par courroux/ comme
¶ Sur le .uii. cõmandement.	¶ Sur le .vii. commandement.
¶ De adultere/ ⁊ paillardise.	¶ De adultere/ et paillardise.
dautruy/ soit aussi qͥl ait cõmis adultere auec la fe	d’autruy/ soit aussi qu’il ait commis adultere avec la fem¬
lard ⁊ la paillarde.3. Moy 20.b. 5. Moyse.22.d.	lard et la paillarde.3. Moy 20.b. 5. Moyse.22.d.
Il nyaura point de paillardes des filles Dis-	Il n’y aura point de paillardes des filles D’is¬
se.23.c.	se.23.c.
que la terre ne soit maculee/ ⁊ rẽplie de peche enor	que la terre ne soit maculee/ et remplie de peche enor¬
me.3. Moyse.19.f.	me.3. Moyse.19.f.
souffre iamais de congnoistre par quelque crime/	souffre jamais de congnoistre par quelque crime/
Iay faict paction auec mes yeux/ que ie ne pen	J’ay faict paction avec mes yeux/ que je ne pen¬
seroye point aussi de la uierge. Iob.1.a.	seroye point aussi de la vierge. Job.1.a.
ilz assemblẽt dõmage ⁊ deshõneur: ⁊ ne peuuẽt ia-	ilz assemblent dommage et deshonneur: et ne peuvent ja¬
Tu ne cõmetteras point adultere. Matth.19.c.	Tu ne commetteras point adultere. Matth.19.c.
Romains.13.c.	Romains.13.c.
uoiter/ il a desia commis adultere auec elle en son	voiter/ il a desja commis adultere avec elle en son
Ne paillardons point/ ainsi que aucuns de eux	Ne paillardons point/ ainsi que aucuns de eux
ont paillarde: ⁊ morurent en un iour uingt ⁊ troys	ont paillarde: et morurent en un jour vingt et troys
Mortifiez uoz mẽbres qui sont sur la terre/ for-	Mortifiez voz membres qui sont sur la terre/ for¬
rice qui est seruice des idoles. Colos.3.a. 1.Pier.4.a	rice qui est service des idoles. Colos.3.a. 1.Pier.4.a
Qui est adioinct a la paillarde/ il est faict un	Qui est adjoinct a la paillarde/ il est faict un
rit. Fuyez paillardise. Tout peche/ que lhomme	rit. Fuyez paillardise. Tout peche/ que l’homme
en son propre corps. 1.Corin.6.d.	en son propre corps. 1.Corin.6.d.
Ceste est la uolunte de Dieu/ uostre sanctifica¬	Ceste est la volunte de Dieu/ vostre sanctifica¬
q̃ un chascun de uous sache posseder son uaisseau	que un chascun de vous sache posseder son vaisseau
de desirs/ ainsi cõme les gentilz/ lesquelz ignorent	de desirs/ ainsi comme les gentilz/ lesquelz ignorent
dieu ⁊c. Car dieu ne nous a point appelle a ordure:	dieu etc. Car dieu ne nous a point appelle a ordure:
Les iniustes/ les paillardz/ ceux qui seruẽt aux	Les injustes/ les paillardz/ ceux qui servent aux
gerons/ les larrõs/ les auaricieux/ les yurõgnes/	gerons/ les larrons/ les avaricieux/ les yvrongnes/
les maldisans/ les rauisseurs ne possederõt point	les maldisans/ les ravisseurs ne possederont point
Paillardise ⁊ ordure quelcõque/ ou auarice/ ne	Paillardise et ordure quelconque/ ou avarice/ ne
nable aux sainctz: ou chose uillaine ⁊ folles pa¬	nable aux sainctz: ou chose villaine et folles pa¬
rolles/ ou farcerie/ qui ne cõuiennent point: mais	rolles/ ou farcerie/ qui ne conviennent point: mais
que nul paillard/ ou souille/ ou auaricieux qui est	que nul paillard/ ou souille/ ou avaricieux qui est
me de Christ/ ⁊ de Dieu. Ephe.5.a.	me de Christ/ et de Dieu. Ephe.5.a.
Cheminõs hõnestemẽt cõme par iour/ nõ point	Cheminons honnestement comme par jour/ non point
⁊ luxures ⁊c. Romains.13.d.	et luxures etc. Romains.13.d.
sans macule. Mais Dieu iugera les paillardz ⁊	sans macule. Mais Dieu jugera les paillardz et
adulteres. Hebr.13.a.	adulteres. Hebr.13.a.
me/ ⁊ une chascune aye son mary. Le mary rende	me/ et une chascune aye son mary. Le mary rende
mẽt la femme au mary. La fẽme na point la puis-	ment la femme au mary. La femme n’a point la puis¬
sance de son corps: mais le mary. Et aussi sembla	sance de son corps: mais le mary. Et aussi sembla¬
mais la femme. Ne retenez poĩt le deu lun de lau¬	mais la femme. Ne retenez point le deu l’un de l’au¬
que uous uacquiez a ieunes ⁊ oraison. Et de rechief	que vous vacquiez a jeunes et oraison. Et de rechief
retournez ensemble: affin que Satan ne uous tẽte/	retournez ensemble: affin que Satan ne vous tente/
nent quilz se mariẽt. Car il uaut mieux se marier	nent qu’ilz se marient. Car il vaut mieux se marier
Il faut que leuesque soit irreprehensible: mary	Il faut que l’evesque soit irreprehensible: mary
dune seule femme/ surueillant/ sobre/ modeste/ ⁊c.	d’une seule femme/ surveillant/ sobre/ modeste/ etc.
me. 1.Timo.3.a.b. Tite p̃mier.b.	me. 1.Timo.3.a.b. Tite premier.b.
cause de fornication: il faict quelle soit adultere.	cause de fornication: il faict qu’elle soit adultere.
Matthieu.5.e.19.b. 1.Corin.7.b.	Matthieu.5.e.19.b. 1.Corin.7.b.
nicateur/ ou auaricieux/ ou seruãt aux idoles/ ou	nicateur/ ou avaricieux/ ou servant aux idoles/ ou
point auec celuy qui est tel. 1.Corin.5.d.	point avec celuy qui est tel. 1.Corin.5.d.
¶ Uoyez) 3. Moyse.18.a.b. Prouer.2.c.	¶ Voyez) 3. Moyse.18.a.b. Prover.2.c.
rin.5.a.b.c. Ephesiẽs.5.b. 1.Timo.1.b.	rin.5.a.b.c. Ephesiẽs.5.b. 1.Timo.1.b.
¶ Sur le .uiii. cõmandement.	¶ Sur le .viii. commandement.
¶ De larcin ⁊ tromperie.	¶ De larcin et tromperie.
thieu.19.c. Romains.13.c.	thieu.19.c. Romains.13.c.
sonne ne deceura son prochain. 3.Moyse.19.b.c.	sonne ne decevra son prochain. 3.Moyse.19.b.c.
Tu ne feras point de extorsion a ton prochain	Tu ne feras point de extorsion a ton prochain
Tu ne feras aucune fausette en iugemẽt/ en rei¬	Tu ne feras aucune fausette en jugement/ en rei¬
ces iustes/ et les poix iustes/ aussi le muyd et le	ces justes/ et les poix justes/ aussi le muyd et le
septier. 3.Moyse.19.g. 5.Moyse.25.c.d.	septier. 3.Moyse.19.g. 5.Moyse.25.c.d.
Dieu/ et le poix iuste luy est aggreable. Prouer¬	Dieu/ et le poix juste luy est aggreable. Prover¬
Celuy qui aura desrobe ⁊ uẽdu lhõme/ sil est cõ	Celuy qui aura desrobe et vendu l’homme/ s’il est con¬
uaĩcu de la coulpe/ qͥl meure de mort. 2.Moy.21.b.	vaincu de la coulpe/ qu’il meure de mort. 2.Moy.21.b.
ame. Prouerbes.29.d.	ame. Proverbes.29.d.
tost qui laboure en besongnant de ses mains/ en ce	tost qui laboure en besongnant de ses mains/ en ce
qui est bon: affin quil aye pour dõner a celuy qui	qui est bon: affin qu’il aye pour donner a celuy qui
Nul ne foulle ou decoiue son frere en aucun af	Nul ne foulle ou decoive son frere en aucun af¬
de toutes ces choses. 1.Thessa.4.b.	de toutes ces choses. 1.Thessa.4.b.
¶ Uoyez) 2.Moyse.22.a.b. Ecclesiaste.5.d.	¶ Voyez) 2.Moyse.22.a.b. Ecclesiaste.5.d.
¶ Sur le .ix. cõmandement.	¶ Sur le .ix. commandement.
mensonge/ ⁊ detraction.	mensonge/ et detraction.
Tu ne diras point faux tesmoignage. 5.Moy¬	Tu ne diras point faux tesmoignage. 5.Moy¬
Tu ne porteras point la parolle de mẽsonge/ ⁊	Tu ne porteras point la parolle de mensonge/ et
moignage iniuste. Tu nensuyuras point la mul¬	moignage injuste. Tu n’ensuyvras point la mul¬
titude pour faire mal/ et ne condescendras point	titude pour faire mal/ et ne condescendras point
que tu desuoye du uray ⁊c. Tu fuyras mensonge.	que tu desvoye du vray etc. Tu fuyras mensonge.
Le faux tesmoing ne demourera point impu¬	Le faux tesmoing ne demourera point impu¬
gny: ⁊ qui parle mensonge/ neschappera point.	gny: et qui parle mensonge/ n’eschappera point.
Celuy qui parle la uerite annõce iustice: mais	Celuy qui parle la verite annonce justice: mais
Le larron est meilleur q̃ la cõtinuelle cõpaignie	Le larron est meilleur que la continuelle compaignie
de lhõme mẽsongier: mais tous deux aurõt perdi¬	de l’homme mensongier: mais tous deux auront perdi¬
Le Seigñr hait ces six choses/ ⁊ la septiesme il	Le Seigneur hait ces six choses/ et la septiesme il
le faux tesmoing ⁊ lauteur de dissention entre les	le faux tesmoing et l’auteur de dissention entre les
freres. Prouerb.9.a.	freres. Proverb.9.a.
Les meurs des hõmes menteurs sont sans hõ¬	Les meurs des hommes menteurs sont sans hon¬
Ecclesiastique.20.d.	Ecclesiastique.20.d.
Ne mẽtez point lun a lautre. Colos.2.b.	Ne mentez point l’un a l’autre. Colos.2.b.
quil garde sa langue de mal/ ⁊ ses leures quelles	qu’il garde sa langue de mal/ et ses leures qu’elles
Ne ayme pas mẽsonge alencontre de ton frere/ ⁊	Ne ayme pas mensonge a l’encontre de ton frere/ et
ne le fais point pareillemẽt a ton amy. Ne uueille	ne le fais point pareillement a ton amy. Ne vueille
diceluy nest pas bonne. Eccłi.7.b.	d’iceluy n’est pas bonne. Eccłi.7.b.
celuy qui parle mensonge perira. Prouer.19.b.	celuy qui parle mensonge perira. Prover.19.b.
Mensonge est un opprobre mauuais en lhom¬	Mensonge est un opprobre mauvais en l’hom¬
sont sans discipline. Ecclesiastique.20.d.	sont sans discipline. Ecclesiastique.20.d.
Lhõme qui dõne faux tesmoignage contre son	L’homme qui donne faux tesmoignage contre son
prochain est une lance/ ⁊ une espee/ et une flesche	prochain est une lance/ et une espee/ et une flesche
La faulse langue ne poeut souffrir celuy qui le	La faulse langue ne poeut souffrir celuy qui le
lice. Prouer.26.g.	lice. Prover.26.g.
Tu ne iras point detracter entre ton peuple.	Tu ne iras point detracter entre ton peuple.
Le detracteur est en abomination aux hommes.	Le detracteur est en abomination aux hommes.
Gardez uous donc de murmuration: laquelle	Gardez vous donc de murmuration: laquelle
ne prouffite de rien/ ⁊ retirez uostre langue de detra	ne prouffite de rien/ et retirez vostre langue de detra¬
Celuy qui feint sõ regard/ faict q̃lque dõmaige:	Celuy qui feint son regard/ faict quelque dommaige:
Uous donc ostans toute malice ⁊ toute dece¬	Vous donc ostans toute malice et toute dece¬
ption ⁊ simulattons ⁊ enuies/ ⁊ toutes detractiõs:	ption et simulations et envies/ et toutes detractions:
laict de la parolle qui est sans deceptiõ: affin q̃ par	laict de la parolle qui est sans deception: affin que par
Mes freres/ ne detractez point lun de lautre.	Mes freres/ ne detractez point l’un de l’autre.
Qui detracte de son frere/ ou qui iuge son frere: il	Qui detracte de son frere/ ou qui juge son frere: il
loy/ tu ne es point facteur de la loy: mais iuge. Il	loy/ tu ne es point facteur de la loy: mais juge. Il
es tu/ qui iuge autruy. Iacques.4.c.	es tu/ qui juge autruy. Jacques.4.c.
Ostez mẽsonge ⁊ parlez uerite un chascun auec	Ostez mensonge et parlez verite un chascun avec
des autres. Ephe.4.f.	des autres. Ephe.4.f.
26.a. Rom̃.1.d. Iac.1.c.3.a. Act̃.5.a.	26.a. Rom̃.1.d. Jac.1.c.3.a. Act̃.5.a.
¶ Sur le .x. cõmandement.	¶ Sur le .x. commandement.
Tu ne cõuoiteras point la fẽme de ton ꝓchain/	Tu ne convoiteras point la femme de ton prochain/
Ie ne congnoissoye point cõcupiscence: se la loy	Je ne congnoissoye point concupiscence: se la loy
ne eut dit. Tu ne conuoiteras point. Ro.7.b.13.c.	ne eut dit. Tu ne convoiteras point. Ro.7.b.13.c.
uerbes.23.a.	verbes.23.a.
gẽt/ ⁊ qui ayme auoir cheuãce nen aura nul fruict.	gent/ et qui ayme avoir chevance n’en aura nul fruict.
Ecclesiaste.5.b.	Ecclesiaste.5.b.
Terre ⁊ cẽdre pourquoy te enorgueillis tu? Il nest	Terre et cendre pourquoy te enorgueillis tu? Il n’est
met son ame en uente. Ecclesiastic.10.b.	met son ame en vente. Ecclesiastic.10.b.
Lauaricieux met toute sa maison en trouble: et	L’avaricieux met toute sa maison en trouble: et
Uoyez/ et uous gardez dauarice: car la uie dun	Voyez/ et vous gardez d’avarice: car la vie d’un
possede. Luc.12.b.	possede. Luc.12.b.
Ie uous dy en uerite/ que a grand difficulte le	Je vous dy en verite/ que a grand difficulte le
ie uous dy: Il est plus facile que un chameau en¬	je vous dy: Il est plus facile que un chameau en¬
tre au royaume des cieux. Matthi.19.c. Marc	tre au royaume des cieux. Matthi.19.c. Marc
10.b. Luc.18.d.	10.b. Luc.18.d.
la rouillure ⁊ tigne corrompt/ ⁊ la ou les larrons	la rouillure et tigne corrompt/ et la ou les larrons
au ciel/ la ou ne la rouillure ne la tigne ne corrõpt	au ciel/ la ou ne la rouillure ne la tigne ne corrompt
rien/ ⁊ la ou les larrons ne effouissent/ ⁊ ne desro¬	rien/ et la ou les larrons ne effouissent/ et ne desro¬
uostre coeur/ la lumiere de ton corps/ cest ton oeil.	vostre coeur/ la lumiere de ton corps/ c’est ton oeil.
mineux: mais se ton oeil est mauuais/ tout ton	mineux: mais se ton oeil est mauvais/ tout ton
corps sera tenebreux ⁊c. Matth.6.c. Luc.12.d.	corps sera tenebreux etc. Matth.6.c. Luc.12.d.
nauons rien aporte en ce monde. Il est manifeste q̃	n’avons rien aporte en ce monde. Il est manifeste que
nourrissemens ⁊ dequoy puissions estre couuers/	nourrissemens et dequoy puissions estre couvers/
soyons contens de ces choses. Car ceux qui ueul¬	soyons contens de ces choses. Car ceux qui veul¬
du diable/ ⁊ en plusieurs desirs folz ⁊ nuisãs/ les¬	du diable/ et en plusieurs desirs folz et nuisans/ les¬
Car la racine de tous maux/ est cõuoitise de riches	Car la racine de tous maux/ est convoitise de riches¬
ses: laquelle aucuns appetans/ ont erre en la foy/ ⁊	ses: laquelle aucuns appetans/ ont erre en la foy/ et
Uoz meurs soyẽt sans auarice. Soyez cõtens	Voz meurs soyent sans avarice. Soyez contens
laisseray point/ ⁊ ne te abãdonneray point: tant q̃	laisseray point/ et ne te abandonneray point: tant que
nous pouons dire en fiãce: Le Seigneur dieu mest	nous povons dire en fiance: Le Seigneur dieu m’est
se faire. Heb.13.a.b.	se faire. Heb.13.a.b.
cupiscence. Puis apres quand la concupiscence a	cupiscence. Puis apres quand la concupiscence a
conceu: elle enfante peche: ⁊ peche quãd il aura este	conceu: elle enfante peche: et peche quand il aura este
Se aucun ayme le mõde/ la charite du pere nest	Se aucun ayme le monde/ la charite du pere n’est
piscence de chair/ ⁊ cõcupiscẽce des yeux/ ⁊ orgueil	piscence de chair/ et concupiscence des yeux/ et orgueil
de uie/ qui nest point du pere: mais est du mõde. Et	de vie/ qui n’est point du pere: mais est du monde. Et
uolunte de dieu/ demoure eternellemẽt. 1.Ieh.2.c.	volunte de dieu/ demoure eternellement. 1.Jeh.2.c.
ses prouffitz. 1.Corin.14.b.	ses prouffitz. 1.Corin.14.b.
Nul ne soit cerchant son bien: mais le biẽ dau¬	Nul ne soit cerchant son bien: mais le bien d’au¬
Que ꝓuffite il a lhõme sil gaigne tout le mon	Que prouffite il a l’homme s’il gaigne tout le mon¬
Cõplainte de Ieremie ⁊ Isaie.) Depuis le petit	Complainte de Jeremie et Isaie.) Depuis le petit
dẽtre eux iusque au grãd/ chascun tache a auarice:	d’entre eux jusque au grand/ chascun tache a avarice:
faulsete. Iere.6.c.8.d. Isa.56.d.	faulsete. Jere.6.c.8.d. Isa.56.d.
parolles. Donne nous auiourdhuy nostre	parolles. Donne nous aujourdhuy nostre
pain ⁊c. Et la similitude Luc.12.c. Item Pro	pain etc. Et la similitude Luc.12.c. Item Pro¬
re.1.a. 2.a.b. Iacques.4.a.	re.1.a. 2.a.b. Jacques.4.a.
mens/ auquel gist toute lobseruatiõ	mens/ auquel gist toute l’observation
⁊ accõplissement diceux.	et accomplissement d’iceux.
Escoute Israel/ le Seigneur nostre	Escoute Israel/ le Seigneur nostre
meras le Seigñr ton Dieu/ de tout ton	meras le Seigneur ton Dieu/ de tout ton
coeur/ ⁊ de toute ton ame/ ⁊ de toute ta	coeur/ et de toute ton ame/ et de toute ta
premier cõmandement.	premier commandement.
Tu aymeras ton prochain comme toy¬	Tu aymeras ton prochain comme toy¬
mesme. Il ny a point dautre cõmande¬	mesme. Il n’y a point d’autre commande¬
Matthieu.22.d.	Matthieu.22.d.
toute la loy ⁊ les ꝓphetes. Mat.22.d.	toute la loy et les prophetes. Mat.22.d.
¶ Et le Scribe luy dit.	¶ Et le Scribe luy dit.
il y a un Dieu/ ⁊ nen ny a point dautre	il y a un Dieu/ et n’en n’y a point d’autre
de tout lentendement/ ⁊ de toute lame/	de tout l’entendement/ et de toute l’ame/
⁊ de toute la force: et aymer son ꝓchain	et de toute la force: et aymer son prochain
tions bruslees ⁊ sacrifices. Marc.12.c.	tions bruslees et sacrifices. Marc.12.c.
respõdu sagemẽt/ luy dit.	respondu sagement/ luy dit.
Tu nes point loing du royaume de	Tu n’es point loing du royaume de
¶ Ces deux cõmandemẽs repetez en le¬	¶ Ces deux commandemens repetez en l’e¬
et .3.Moyse.19.d.	et .3.Moyse.19.d.
¶ Sainct Iehan.13.d.	¶ Sainct Jehan.13.d.
uous aymez lun lautre/ comme ie uous ay ayme:	vous aymez l’un l’autre/ comme je vous ay ayme:
cela tous cõgnoistront q̃ uous estes mes disciples/	cela tous congnoistront que vous estes mes disciples/
que uous auez dilection lun a lautre.	que vous avez dilection l’un a l’autre.
Nous donc aymons le: car iceluy premier nous	Nous donc aymons le: car iceluy premier nous
re: il est menteur. Car qui nayme point son frere	re: il est menteur. Car qui n’ayme point son frere
quil uoit/ comment poeut il aymer Dieu/ quil ne	qu’il voit/ comment poeut il aymer Dieu/ qu’il ne
celuy qui ayme dieu/ quil ayme aussi son frere.	celuy qui ayme dieu/ qu’il ayme aussi son frere.
Ne deuez rien a personne: sinon que uous ay¬	Ne devez rien a personne: sinon que vous ay¬
miez lun lautre. Car qui ayme son prochain: il a	miez l’un l’autre. Car qui ayme son prochain: il a
Tu ne occiras point. Tu ne desroberas point.	Tu ne occiras point. Tu ne desroberas point.
uoiteras point. Et sil ya aucun autre comman¬	voiteras point. Et s’il y a aucun autre comman¬
dement: il est sommairement cõpris en ceste parol¬	dement: il est sommairement compris en ceste parol¬
me toymesme. La dilection ne faict au prochain	me toymesme. La dilection ne faict au prochain
dilection.	dilection.
¶ Item Gala.5.c.	¶ Item Gala.5.c.
aymeras ton prochain comme toymesme.	aymeras ton prochain comme toymesme.
La fin du commandement est charite/ de coeur	La fin du commandement est charite/ de coeur
pur/ ⁊ de bonne conscience/ ⁊ de foy non feinte.	pur/ et de bonne conscience/ et de foy non feinte.
en Christ ⁊ par Christ.	en Christ et par Christ.
plir. Matth.5.c.	plir. Matth.5.c.
La loy ne meine rien a perfectiõ: mais est lintro	La loy ne meine rien a perfection: mais est l’intro¬
chons a dieu. Heb.7.c.	chons a dieu. Heb.7.c.
cte ferme/ ⁊ se toute trãsgressiõ ⁊ inobediẽce a receu	cte ferme/ et se toute transgression et inobedience a receu
iuste retributiõ du loyer: cõmẽt euiterõs noꝰ se noꝰ	juste retribution du loyer: comment eviterons nous se nous
ainsi soit quil ayt cõmẽce destre racõte par nostre	ainsi soit qu’il ayt commence d’estre raconte par nostre
ouy/ ⁊ approuue de dieu par signes ⁊ miracles ⁊ di	ouy/ et approuve de dieu par signes et miracles et di¬
uerses puissances ⁊ distributions du sainct esperit	verses puissances et distributions du sainct esperit
La fin de la loy/ est Christ/ en salut a tout	La fin de la loy/ est Christ/ en salut a tout
La loy de lesperit de uie en Iesus Christ/ ma	La loy de l’esperit de vie en Jesus Christ/ m’a
deliure de la loy de peche et de mort. Car ce qui	delivre de la loy de peche et de mort. Car ce qui
infirme par la chair: Dieu a enuoye son filz en si¬	infirme par la chair: Dieu a envoye son filz en si¬
ne le peche en la chair/ affin que la iustification	ne le peche en la chair/ affin que la justification
de la loy fusse accomplie en nous qui ne chemi¬	de la loy fusse accomplie en nous qui ne chemi¬
Romains.8.a.	Romains.8.a.
un/ ⁊ a rõpu la paroy du milieu de la closture/ les	un/ et a rompu la paroy du milieu de la closture/ les
inimitiez/ par sa chair: mettant a neant la loy des	inimitiez/ par sa chair: mettant a neant la loy des
tue deux en soymesme en un hõme nouueau/ fai¬	tue deux en soymesme en un homme nouveau/ fai¬
corps/ par la croix/ destruisant les inimitiez par	corps/ par la croix/ destruisant les inimitiez par
soymesme. Ephe.2.d.	soymesme. Ephe.2.d.
aux Rõmains/ Gala. Ephe. ⁊ Hebr.	aux Rommains/ Gala. Ephe. et Hebr.
peres ⁊ maistres de familles/ affin quilz	peres et maistres de familles/ affin qu’ilz
ꝓposent ⁊ enseignẽt sa loy/ principalle¬	proposent et enseignent sa loy/ principalle¬
Et ces parolles cy/ lesquelles moy	Et ces parolles cy/ lesquelles moy¬
en ton coeur/ ⁊ les racõteras a tes filz/ et	en ton coeur/ et les raconteras a tes filz/ et
leur diras/ toy estant assis en ta maison	leur diras/ toy estant assis en ta maison
⁊ en te leuant. Et les lieras pour signe	et en te levant. Et les lieras pour signe
tre tes yeux/ ⁊ les escriras a lentree de	tre tes yeux/ et les escriras a l’entree de
ta maison/ ⁊ a tes portes. 5.Moy.6.b.	ta maison/ et a tes portes. 5.Moy.6.b.
nuer/ a la loy ⁊ parolle de Dieu/ mais	nuer/ a la loy et parolle de Dieu/ mais
a dextre ou a senestre.	a dextre ou a senestre.
Uous ne adiousterez aux parolles/	Vous ne adjousterez aux parolles/
⁊ nen diminuerez dicelles. 5.Moy.4.a.	et n’en diminuerez d’icelles. 5.Moy.4.a.
mesme ie uous cõmande/ uous les gar¬	mesme je vous commande/ vous les gar¬
derez pour les faire sãs adiouster a icel	derez pour les faire sans adjouster a icel¬
Uous les garderez pour les faire/ cõ¬	Vous les garderez pour les faire/ com¬
de/ sans decliner ne a dextre ne a sene¬	de/ sans decliner ne a dextre ne a sene¬
stre. 5.Moyse.5.d.	stre. 5.Moyse.5.d.
les/ affin quil ne te reprenne/ ⁊ que soye	les/ affin qu’il ne te reprenne/ et que soye
Ia soit que nous/ ou un ange du ciel	Ja soit que nous/ ou un ange du ciel
uous euangelize autrement que ce que	vous evangelize autrement que ce que
malediction. Ainsi que nous auons dit	malediction. Ainsi que nous avons dit
aucun uous euangelize autrement que	aucun vous evangelize autrement que
ce que uous auez receu: il soit en maledi	ce que vous avez receu: il soit en maledi¬
¶ Sur la salutation angelicque/	¶ Sur la salutation angelicque/
Aue maria.	Ave maria.
¶ Pour lintelligẽce de la salutation angelique	¶ Pour l’intelligence de la salutation angelique
articles: ausquelz auras recours. Toutesfoys icy	articles: ausquelz auras recours. Toutesfoys icy
oraison est priere/ requeste et demande faicte enuers	oraison est priere/ requeste et demande faicte envers
dieu: comme/ Ton royaume aduienne/ Donne	dieu: comme/ Ton royaume advienne/ Donne
tation est benediction/ bien uouloir/ et gracieux	tation est benediction/ bien vouloir/ et gracieux
disant: Dieu te salue ⁊ garde. Dieu te doint bon	disant: Dieu te salue et garde. Dieu te doint bon
iour/ ou bon soir/ Paix a toy. Beneit soys tu/ ⁊c.	jour/ ou bon soir/ Paix a toy. Beneit soys tu/ etc.
rie en sainct Luc.1. Item en Daniel.10.b. Item	rie en sainct Luc.1. Item en Daniel.10.b. Item
uers ses apostres. Iehan.20.e. Item S. Paul ⁊	vers ses apostres. Jehan.20.e. Item Sainct Paul et
S. Pierre/ au commencement de leurs epistres.	Sainct Pierre/ au commencement de leurs epistres.
qui pareillement ont este benites	qui pareillement ont este benites
Ioachin le grand prestre uint de Hierusalem	Joachin le grand prestre vint de Hierusalem
en Bethulie auec tous ses prestres pour ueoir Iu¬	en Bethulie avec tous ses prestres pour veoir Ju¬
rent/ disãs tous dune uoix: Tu es la gloire de Hie¬	rent/ disans tous d’une voix: Tu es la gloire de Hie¬
nr̃e peuple: qͥ as ouure uirilement/ et ton coeur a	nostre peuple: qui as ouvre virilement/ et ton coeur a
este conforte/ pour ce que tu as ayme chastete/ ⁊ que	este conforte/ pour ce que tu as ayme chastete/ et que
pourtant aussi ta conforte la main du seigneur: et	pourtant aussi t’a conforte la main du seigneur: et
Et tout le peuple dit: Ainsi soit il: Ainsi soit il.	Et tout le peuple dit: Ainsi soit il: Ainsi soit il.
Iudith.15.d.	Judith.15.d.
Aber Cyneen/ ⁊ soit beneite en son tabernacle.	Aber Cyneen/ et soit beneite en son tabernacle.
Lia dit: Cest pour ma beatitude. Car les fẽmes	Lia dit: C’est pour ma beatitude. Car les femmes
me diront bienheureuse. Geñ.30.b.	me diront bienheureuse. Geñ.30.b.
rain par dessus toutes les femmes/ qui sont sur la	rain par dessus toutes les femmes/ qui sont sur la
¶ Pour laquelle cause la uierge	¶ Pour laquelle cause la vierge
Marie fut dicte bien¬	Marie fut dicte bien¬
Beneite es tu qui a creu: car les choses qui	Beneite es tu qui a creu: car les choses qui
ctes. Luc.1.e.	ctes. Luc.1.e.
¶ Cõment aussi seront bienheureux	¶ Comment aussi seront bienheureux
Bienheureux est le uẽtre qui ta porte: ⁊ les mã¬	Bienheureux est le ventre qui t’a porte: et les mam¬
tes/ bienheureux sont ceux qui oyent la parolle de	tes/ bienheureux sont ceux qui oyent la parolle de
dieu/ ⁊ la gardent. Luc.11.d.	dieu/ et la gardent. Luc.11.d.
enseigner/ ou prendre sa refection.	enseigner/ ou prendre sa refection.
uoꝰ a psalme/ il a doctrine/ il a lãguaige/ ⁊ il a re¬	vous a psalme/ il a doctrine/ il a languaige/ et il a re¬
uelation/ il a interpretation: toute chose soit faicte	velation/ il a interpretation: toute chose soit faicte
Donc soit que uous mangez/ soit que uoꝰ beu¬	Donc soit que vous mangez/ soit que vous beu¬
ctes les toutes/ pour la gloire de dieu. 1.Cor.10.g.	ctes les toutes/ pour la gloire de dieu. 1.Cor.10.g.
Certes lesperit dit manifestement que aux der¬	Certes l’esperit dit manifestement que aux der¬
reille aux esperitz derreur: ⁊ aux doctrines des dia¬	reille aux esperitz d’erreur: et aux doctrines des dia¬
ges ⁊ ont leur consciẽce cauterizee/ defendans soy	ges et ont leur conscience cauterizee/ defendans soy
marier/ cõmandãs de se abstenir des uiandes les¬	marier/ commandans de se abstenir des viandes les¬
ces aux fideles/ ⁊ a ceux qui ont cõgneu la uerite.	ces aux fideles/ et a ceux qui ont congneu la verite.
reiecter de laquelle on use auec actiõ de graces. Car	rejecter de laquelle on use avec action de graces. Car
elle est sanctifiee par la parolle de dieu/ ⁊ par orai¬	elle est sanctifiee par la parolle de dieu/ et par orai¬
Exemple de Christ.	Exemple de Christ.
pit ⁊ le donna a ses disciples ⁊c. Et quãd ilz eurent	pit et le donna a ses disciples etc. Et quand ilz eurent
dit la louenge/ ilz se partirent. Matth.26.c.	dit la louenge/ ilz se partirent. Matth.26.c.
Dieu ayt pitie de nous: ⁊ nous benye/ ⁊ face re¬	Dieu ayt pitie de nous: et nous benye/ et face re¬
la terre ta uoye/ ⁊ entre toutes gẽs tõ salut. ps̈.67.a	la terre ta voye/ et entre toutes gens ton salut. ps̈.67.a
¶ Autre.	¶ Autre.
rolle/ ou en oeuure: faictes les toutes au nom de	rolle/ ou en oeuvre: faictes les toutes au nom de
⁊ au pere par luy. Colos.3.c.	et au pere par luy. Colos.3.c.
¶ Autre.	¶ Autre.
Christ/ qui nous a beneit en toute benediction spiri	Christ/ qui nous a beneit en toute benediction spiri¬
a esleu en luy deuãt la cõstitution du mõde: affin	a esleu en luy devant la constitution du monde: affin
que nous fussions sainctz/ ⁊ sans reprehension/ de¬	que nous fussions sainctz/ et sans reprehension/ de¬
¶ Autre oraison.	¶ Autre oraison.
plus abondãment q̃ ne demandõs/ ne apperceuõs	plus abondamment que ne demandons/ ne appercevons
selon la puissance/ laquelle oeuure en nous: a ice¬	selon la puissance/ laquelle oeuvre en nous: a ice¬
les generatiõs du siecle des siecles. Amẽ. Eph.3.d	les generations du siecle des siecles. Amen. Eph.3.d
biens que auons receu de dieu.	biens que avons receu de dieu.
Quand tu auras mange/ ⁊ que sera repeu: prẽs	Quand tu auras mange/ et que sera repeu: prens
tire du pays Degypte/ de la maison de seruitude.	tire du pays D’egypte/ de la maison de servitude.
¶ Oraison ⁊ louenge apres le repas.	¶ Oraison et louenge apres le repas.
Au roy des siecles/ immortel/ inuisible/ a Dieu	Au roy des siecles/ immortel/ invisible/ a Dieu
cles. Amen. 1.Timothee.1.d.	cles. Amen. 1.Timothee.1.d.
celuy qͥ est assis au throne ⁊ a laigneau eis siecles	celuy qui est assis au throne et a l’aigneau eis siecles
des siecles. Amen. Apocalip.5.d.	des siecles. Amen. Apocalip.5.d.
Louenge ⁊ clairte/ ⁊ sapiẽce/ ⁊ action de graces/	Louenge et clairte/ et sapience/ et action de graces/
siecles. Amen. Apocalip.7.c.	siecles. Amen. Apocalip.7.c.
¶ Generale benediction.	¶ Generale benediction.
enfãs Disrael/ ⁊ leur diras: Dieu te benye/ ⁊ te	enfans D’israel/ et leur diras: Dieu te benye/ et te
de toy/ Dieu uueille tourner sa face uers toy/ ⁊	de toy/ Dieu vueille tourner sa face vers toy/ et
te dõne paix. Ilz inuoquerõt mon nom sur les	te donne paix. Ilz invoqueront mon nom sur les
¶ Autre benedictiõ sur ceux qui gardent	¶ Autre benediction sur ceux qui gardent
Si tu escoute la uoix du Seigñr ton Dieu ⁊c.	Si tu escoute la voix du Seigneur ton Dieu etc.
5.Moyse.28.	5.Moyse.28.
iustice: et toutes choses uous seront adioustees.	justice: et toutes choses vous seront adjoustees.
¶ Fais ce/ ⁊ tu uiuras. Luc.10.	¶ Fais ce/ et tu vivras. Luc.10.
¶ Aduertissement au lecteur/ pour les	¶ Advertissement au lecteur/ pour les
saincte Bible.	saincte Bible.
noms des liures de la Bible/ icy les auons sub¬	noms des livres de la Bible/ icy les avons sub¬
scritz. Mais cõsiderans la corruption ⁊ mutation	scritz. Mais considerans la corruption et mutation
eis langues estrangieres (ce que est escheu entre les	eis langues estrangieres (ce que est escheu entre les
Et aussi S. Hierosme: tant des latins q̃ des grecz)	Et aussi Sainct Hierosme: tant des latins que des grecz)
auõs tasche aucunemẽt icy restituer lesdictz noms	avons tasche aucunement icy restituer lesdictz noms
tion/ qui nest point de petite utilite: pour mieux	tion/ qui n’est point de petite utilite: pour mieux
pture saincte. Cõme cy apres (dieu aydant) nous	pture saincte. Comme cy apres (dieu aydant) nous
demonstrerons amplement au cayer des interpre¬	demonstrerons amplement au cayer des interpre¬
Bible. Au surplus pour la grande difficulte de la	Bible. Au surplus pour la grande difficulte de la
aucunesfoys ne se peut (cõme dit Pline) deument	aucunesfoys ne se peut (comme dit Pline) deument
prononcer: auons suyui la plus doulce prononcia	prononcer: avons suyvi la plus doulce prononcia¬
iadis estoit: lappropriãt a nostre usai¬	jadis estoit: l’appropriant a nostre usai¬
trop superstitieuse	trop superstitieuse
orthographie	orthographie
¶ Les noms des liures Canoniques	¶ Les noms des livres Canoniques
1.Moyse/ autremẽt Genese/ cõtient Chap.50.	1.Moyse/ autrement Genese/ contient Chap.50.
2.Moyse/ autrement Exode/ contient Chap̃.40.	2.Moyse/ autrement Exode/ contient Chap̃.40.
4.Moyse/ autremẽt Nombres/ cõtient Chap̃.36.	4.Moyse/ autrement Nombres/ contient Chap̃.36.
Iehosue/ autrement Iosue/ contient Chap̃.24.	Jehosue/ autrement Josue/ contient Chap̃.24.
Iuges/ contient Chap̃.21.	Juges/ contient Chap̃.21.
1.Semuel/ autremẽt. 1.des Roix/ cõtient Chap̃.31.	1.Semuel/ autrement. 1.des Roix/ contient Chap̃.31.
1.des Roix/ autrement 3. contient Chap̃.22.	1.des Roix/ autrement 3. contient Chap̃.22.
2.des Roix/ autrement 4. contient Chap̃.25.	2.des Roix/ autrement 4. contient Chap̃.25.
2.des Croniq̃s/ autre. Paralipome. ꝯtiẽt Chap̃.36.	2.des Croniques/ autre. Paralipome. contient Chap̃.36.
Nehemiah/ autremẽt. 2.Esdras/ cõtient Chap̃.13.	Nehemiah/ autrement. 2.Esdras/ contient Chap̃.13.
Esther/ contient Chap̃.10.	Esther/ contient Chap̃.10.
Le liure des Psalmes/ contient. 150.	Le livre des Psalmes/ contient. 150.
Ecclesiaste/ autremẽt le prescheur/ cõtiẽt Chap̃.12.	Ecclesiaste/ autrement le prescheur/ contient Chap̃.12.
Les Cantiques de Solomon/ contient Chap.8.	Les Cantiques de Solomon/ contient Chap.8.
Ieremiah/ autrement Ieremie/ cõtient Chap̃.52.	Jeremiah/ autrement Jeremie/ contient Chap̃.52.
contient Chapitres.5.	contient Chapitres.5.
Iehezeciel/ autrement Ezechiel/ cõtient Chap.48.	Iehezeciel/ autrement Ezechiel/ contient Chap.48.
Hosee/ autrement Osee/ cõtient Chap̃.14.	Hosee/ autrement Osee/ contient Chap̃.14.
Amos/ contient Chap̃.9.	Amos/ contient Chap̃.9.
Obdiah/ autrement Abdee/ contient Chap̃.1.	Obdiah/ autrement Abdee/ contient Chap̃.1.
Michah/ autrement Michee/ cõtient Chap̃.7.	Michah/ autrement Michee/ contient Chap̃.7.
Habacuc/ autrement Abacuc/ contient Chap̃.3.	Habacuc/ autrement Abacuc/ contient Chap̃.3.
Zephaniah/ autremẽt Sophonias/ cõtiẽt Cha.3.	Zephaniah/ autrement Sophonias/ contient Cha.3.
Zechariah/ autrement zacharie/ cõtient Chap̃.14.	Zechariah/ autrement zacharie/ contient Chap̃.14.
¶ Sensuiuent les liures Apocriphes/ qui ne	¶ S’ensuivent les livres Apocriphes/ qui ne
sõt point receuz des Hebrieux: mais nous les	sont point receuz des Hebrieux: mais nous les
logue sur les Prouerbes) poͬ linstruction du	logue sur les Proverbes) pour l’instruction du
des doctrines Ecclesiastiques.	des doctrines Ecclesiastiques.
Tobiah/ autrement Tobie/ contient Chap̃.14.	Tobiah/ autrement Tobie/ contient Chap̃.14.
Esther depuis la lr̃e .B. du .x. chap̃. iusq̃ en la fin.	Esther depuis la lettre .B. du .x. chap̃. jusque en la fin.
Iesue filz de Sirach/ autrement Ecclesiastique/	Iesue filz de Sirach/ autrement Ecclesiastique/
contient Chapitres.51.	contient Chapitres.51.
Lepistre de Ieremie.	L’epistre de Jeremie.
Lhistoire de Susanne.	L’histoire de Susanne.
Du dragon/ de bel.	Du dragon/ de bel.
Le. 2.des Machabees/ contient Chap̃.15.	Le. 2.des Machabees/ contient Chap̃.15.
¶ Sensuyuent les liures du	¶ S’ensuyuent les livres du
nouueau testamẽt.	nouveau testament.
S. Marc/ contient Chap̃.16.	Sainct Marc/ contient Chap̃.16.
S. Iehan/ contient Chap̃.21.	Sainct Jehan/ contient Chap̃.21.
Actes ou faictz des Apostres/ par S. Luc/ cõtient	Actes ou faictz des Apostres/ par Sainct Luc/ contient
S. Paul aux Romains/ contient Chap̃.16.	Sainct Paul aux Romains/ contient Chap̃.16.
2.des Corinthiens/ contient Chap̃.13.	2.des Corinthiens/ contient Chap̃.13.
Aux Galates/ cõtient Chap̃.6.	Aux Galates/ contient Chap̃.6.
Aux Philippiens/ contient Chap̃.4.	Aux Philippiens/ contient Chap̃.4.
La. 1.aux Thessaloniciens/ contient Chap̃.5.	La. 1.aux Thessaloniciens/ contient Chap̃.5.
2.aux Thessaloniciens/ cõtient Chap̃.3.	2.aux Thessaloniciens/ contient Chap̃.3.
2.a Timothee/ contient Chap̃.4.	2.a Timothee/ contient Chap̃.4.
A Philomene/ contient Chap̃.1.	A Philomene/ contient Chap̃.1.
Aux Hebrieux/ contient Chap̃.13.	Aux Hebrieux/ contient Chap̃.13.
1.Epistre de S. Pierre/ contient Chap̃.5.	1.Epistre de Sainct Pierre/ contient Chap̃.5.
1.Epistre de sainct Iehan/ contient Chap̃.5.	1.Epistre de sainct Jehan/ contient Chap̃.5.
2.Epistre de sainct Iehan/ contient Chap̃.1.	2.Epistre de sainct Jehan/ contient Chap̃.1.
Epistre de sainct Iude/ contient Chap̃.1.	Epistre de sainct Jude/ contient Chap̃.1.
¶ Les dessusdictz liures enseignẽt ce.	¶ Les dessusdictz livres enseignent ce.
¶ Quil est un dieu tout puissãt/ tout sage/ ⁊ tout	¶ Qu’il est un dieu tout puissant/ tout sage/ et tout
¶ Quil a forme Adam/ a son image ⁊ similitude:	¶ Qu’il a forme Adam/ a son image et similitude:
Adam/ peche est entre au monde/ ⁊ q̃ nous sommes	Adam/ peche est entre au monde/ et que nous sommes
tous en Adam/ ⁊ par Adam pecheurs.	tous en Adam/ et par Adam pecheurs.
ceu la loy/ affin q̃ par icelle ꝯgnoissãs leͬs pechez	ceu la loy/ affin que par icelle congnoissans leurs pechez
tisfaire de leͬs pechez/ ⁊ accõplir la loy par iceluy.	tisfaire de leurs pechez/ et accomplir la loy par iceluy.
¶ Que Christ est nay en temps constitue de Dieu	¶ Que Christ est nay en temps constitue de Dieu
doit. Et non point pour les bonnes oeuures dau¬	doit. Et non point pour les bonnes oeuvres d’au¬
me ueritable il nous fist grace ⁊ misericorde.	me veritable il nous fist grace et misericorde.
¶ Que Christ est nr̃e uie/ uoye/ uerite/ paix/ iusti¬	¶ Que Christ est nostre vie/ voye/ verite/ paix/ justi¬
pour le salut de tous/ ⁊ resuscite pour nostre iusti	pour le salut de tous/ et resuscite pour nostre justi¬
craindre: ⁊ les bons attendre la uie eternelle.	craindre: et les bons attendre la vie eternelle.
¶ Sensuyuent les noms des	¶ S’ensuyvent les noms des
phres/ auec leurs	phres/ avec leurs
ung deux troys quattre cinq six sept huyct neuf	ung deux troys quattre cinq six sept huyct neuf
.i. .ii. .iii. .iiii. .u. .ui. .uii. .uiii. .ix.	.i. .ii. .iii. .iiii. .v. .vi. .vii. .viii. .ix.
dix unze douze treize quatorze quinze seize dixsept	dix unze douze treize quatorze quinze seize dixsept
10 11 12 13 14  15 16  17	10 11 12 13 14 15 16 17
dixhuyct dixneuf uingt uingtung uingtdeux	dixhuyct dixneuf vingt vingtung vingtdeux
18 19 20 21 22	18 19 20 21 22
.xxiii. .xxiiii. .xxu. .xxui.	.xxiii. .xxiiii. .xxv. .xxvi.
23 24 25 26	23 24 25 26
.xxuii. .xxuiii. .xxix. .xxx. .xxxi.	.xxvii. .xxviii. .xxix. .xxx. .xxxi.
trẽtedeux trẽtetroys trẽtequattre trẽtecinq trẽtesix	trentedeux trentetroys trentequattre trentecinq trentesix
.xxxii. .xxxiii. .xxxiiii. .xxxu. .xxxui.	.xxxii. .xxxiii. .xxxiiii. .xxxv. .xxxvi.
trẽtesept trẽtehuyct trẽteneuf quarãte quarãteung	trentesept trentehuyct trenteneuf quarante quaranteung
37 38 39 40 41	37 38 39 40 41
quarantedeux quarantetroys quarantequattre	quarantedeux quarantetroys quarantequattre
42 43 44	42 43 44
.xlu. .xlui. .xluii. .xluiii.	.xlv. .xlvi. .xlvii. .xlviii.
45 46 47 48	45 46 47 48
.xlix. .l. .li. .lii.	.xlix. .l. .li. .lii.
cinquantetroys cinquantequattre cinquantecinq	cinquantetroys cinquantequattre cinquantecinq
.liii. .liiii. .lu.	.liii. .liiii. .lv.
cinquantesix cinquantesept cinquantehuyct	cinquantesix cinquantesept cinquantehuyct
56 57 58	56 57 58
cinquãteneuf soixante soixãteung soixãtedeux	cinquanteneuf soixante soixanteung soixantedeux
59 60 61 62	59 60 61 62
.lxiii. .lxiiii. .lxu.	.lxiii. .lxiiii. .lxv.
63 64 65	63 64 65
.lxui. .lxuii. .lxuiii. .lxix.	.lxvi. .lxvii. .lxviii. .lxix.
septante septãteung septantedeux septantetroys	septante septanteung septantedeux septantetroys
.lxx. .lxxi. .lxxii. .lxxiii.	.lxx. .lxxi. .lxxii. .lxxiii.
septãtequattre septãtecinq septãtesix septãtesept	septantequattre septantecinq septantesix septantesept
74 75 76 77	74 75 76 77
septantehuyct septanteneuf octante octanteung	septantehuyct septanteneuf octante octanteung
78 79 80 81	78 79 80 81
.lxxxii. .lxxxiii. .lxxxiiii. .lxxxu.	.lxxxii. .lxxxiii. .lxxxiiii. .lxxxv.
82 83 84 85	82 83 84 85
.lxxxui. .lxxxuii. .lxxxuiii. .lxxxix.	.lxxxvi. .lxxxvii. .lxxxviii. .lxxxix.
nonante nonanteung nonãtedeux nonantetroys	nonante nonanteung nonantedeux nonantetroys
.xc. .xci. .xcii. .xciii.	.xc. .xci. .xcii. .xciii.
nonãtequattre nonãtecinq nonãtesix nonãtesept	nonantequattre nonantecinq nonantesix nonantesept
94 95 96 97	94 95 96 97
nonãtehuyct nonãteneuf cent centung centdeux	nonantehuyct nonanteneuf cent centung centdeux
98 99 100 101 102	98 99 100 101 102
.ciii. .ciiii. .cu. .cui. .cuii. .cuiii.	.ciii. .ciiii. .cv. .cvi. .cvii. .cviii.
103 104 105 106 107 108	103 104 105 106 107 108
autres nombres.	autres nombres.
Ceste figure 0 a parsoy ne faict nul nõbre	Ceste figure 0 a par soy ne faict nul nombre
mais ioincte auec les autres elle les multi¬	mais joincte avec les autres elle les multi¬
60 70 80 90 100 Quand il ya	60 70 80 90 100 Quand il y a
le nombre: il faut commencer a la dextre ⁊	le nombre: il faut commencer a la dextre et
monter a la senestre: disant/ Nombre 1	monter a la senestre: disant/ Nombre 1
Dix mille 10000 Cent mille 100000	Dix mille 10000 Cent mille 100000
Cent millions 100000000 Dix cens	Cent millions 100000000 Dix cens
millions 1000000000	millions 1000000000
¶ Pour enseigner les enfans a prononcer plus	¶ Pour enseigner les enfans a prononcer plus
motz de lautre/ a denotter q̃ premierement doiuent	motz de l’autre/ a denotter que premierement doivent
apprẽdre a sõner les lettres q̃ les nõmer: ie appelle	apprendre a sonner les lettres que les nommer: je appelle
quand on les accõmodera aux sons/ sibilations/ ⁊	quand on les accommodera aux sons/ sibilations/ et
ceans/ sãs aucunemẽt trainer/ ne sõner la lettre .e.	ceans/ sans aucunement trainer/ ne sonner la lettre .e.
masculine. Cõe quãd uoudras ꝓnõcer la lettre .s/	masculine. Comme quand voudras prononcer la lettre .s/
oye/ mais courte ⁊ subite sans queue. Pour .r. la	oye/ mais courte et subite sans queue. Pour .r. la
te ou cãne: ⁊ ainsi consequãment des autres/ cõme	te ou canne: et ainsi consequamment des autres/ comme
pourras feindre. Item poͬ la cõuenance du son qͥ	pourras feindre. Item pour la convenance du son qui
ctemẽt ꝓnõcer: affin quon ne ꝓnonce .b/ pour .p/ c.	ctement prononcer: affin qu’on ne prononce .b/ pour .p/ c.
au cõtraire. Itẽ noteras en lãgue frãcoyse estre	au contraire. Item noteras en langue francoyse estre
plus de diphthõgues q̃ en grec ne en latin/ cõme est	plus de diphthongues que en grec ne en latin/ comme est
pour les sõner. Itẽ en icelle lãgue/ cõe en Hebrieu	pour les sonner. Item en icelle langue/ comme en Hebrieu
auõs discerne par deux accẽtz ⁊ poinctes/ dont lun	avons discerne par deux accentz et poinctes/ dont l’un
se appelle graue/ figure cõe une petite ligne abais¬	se appelle grave/ figure comme une petite ligne abais¬
traire abaissant le deuãt. De ce/ exẽple en as en	traire abaissant le devant. De ce/ exemple en as en
p̃sent/ a la differẽce du tẽps passe: Dõné/ cestadire	present/ a la difference du temps passe: Donné/ c’est a dire
il a dõné. Autre exẽple/ du tẽps passe aux articles	il a donné. Autre exemple/ du temps passe aux articles
rẽce du tẽps present. Laq̃lle distinction est assez uti	rence du temps present. Laquelle distinction est assez uti¬
pour distinguer certain temps ⁊ differẽces de motz	pour distinguer certain temps et differences de motz
doubteux/ signifiãs plusieͬs choses. Par ce moyen	doubteux/ signifians plusieurs choses. Par ce moyen
ces/ tãt en escriuãt q̃ en ꝓnõceãt: cõme aucuns mal	ces/ tant en escrivant que en prononceant: comme aucuns mal
pour scriptura: ⁊c. Que si telle cõsideration eut este	pour scriptura: etc. Que si telle consideration eut este
iadis obtenue: les motz q̃ auõs des latins usurpez/	jadis obtenue: les motz que avons des latins usurpez/
blemẽt deschirez/ ⁊ corrõpus: tellemẽt q̃ a grãde dif	blement deschirez/ et corrompus: tellement que a grande dif¬
mologie. Item en nostre lãgue on pourra obser¬	mologie. Item en nostre langue on pourra obser¬
uer (cõme anciennemẽt en latin ⁊ grec: et auiour¬	ver (comme anciennement en latin et grec: et aujour¬
Petrarche ⁊ Dantes) certaines figures/ tãt en ꝓse	Petrarche et Dantes) certaines figures/ tant en prose
grec q̃ nous pouõs appeller retraicte/ ou reuolte: ⁊	grec que nous povons appeller retraicte/ ou revolte: et
a figure/ comme un traict courbe en forme de petit	a figure/ comme un traict courbe en forme de petit
senestre. Et sert ladicte figure poͬ absorber ou en¬	senestre. Et sert ladicte figure pour absorber ou en¬
par une uoyelle ou diphthõgue/ pour euiter la ru¬	par une voyelle ou diphthongue/ pour eviter la ru¬
de ⁊ mauuaise pronõciation/ cõme as exemple au	de et mauvaise prononciation/ comme as exemple au
que le Eternel. Synaleiphe est une autre figure	que le Eternel. Synaleiphe est une autre figure
peut estre dite raclure ou depositiõ/ soit de la uoyel	peut estre dite raclure ou deposition/ soit de la voyel¬
le ou de la cõsonnãte: pourtãt quelle oste la dernie	le ou de la consonnante: pourtant qu’elle oste la dernie¬
a grãde force/ disons a grãd' force: pour nous som	a grande force/ disons a grand’ force: pour nous som¬
pour nous auõs. Mais de ces figures en Quinti¬	pour nous avons. Mais de ces figures en Quinti¬
lien/ en est escrit amplemẽt. Et si en attendons de	lien/ en est escrit amplement. Et si en attendons de
la langue frãcoyse: parquoy ie men deporte.	la langue francoyse: parquoy je m’en deporte.
ꝓnoncer/ les lõgues ⁊ les brefues: cõme en ce mot	prononcer/ les longues et les brefves: comme en ce mot
icy quotidien: se doit un petit plus arrester sur la	icy quotidien: se doit un petit plus arrester sur la
ger /di. La longue dõc/ soit cõme un traict longuet	ger /di. La longue donc/ soit comme un traict longuet
des dix cõmandemẽs q̃ auõs restitue en leur ordre:	des dix commandemens que avons restitue en leur ordre:
ce na point este faict sans lauctorite des anciens/	ce n’a point este faict sans l’auctorite des anciens/
Ioseph en ses antiqͥtez/ ⁊ de Origene en Exode:	Joseph en ses antiquitez/ et de Origene en Exode:
nu ⁊ plus grand ne pourroit (qui est idolatrie) car	nu et plus grand ne pourroit (qui est idolatrie) car
en ostãt le second/ ⁊ en faisant du dernier deux: on	en ostant le second/ et en faisant du dernier deux: on
teur nostre dieu/ qui est de ne auoir nulles images	teur nostre dieu/ qui est de ne avoir nulles images
mẽt offẽse: ueu quil auoit estroictemẽt defendu/ de	ment offense: veu qu’il avoit estroictement defendu/ de
ne adiouster ne diminuer a sa parolle.	ne adjouster ne diminuer a sa parolle.
M. A son bon frere Ant.	M. A son bon frere Ant.
¶ Trescher frere long tẽps ya q̃ tu desirois le petit	¶ Tres cher frere longtemps y a que tu desirois le petit
traicte des reigles/ ⁊ maniere de ꝓceder en nr̃e uul¬	traicte des reigles/ et maniere de proceder en nostre vul¬
chãt les sons ⁊ noms des lettres/ les apostrophes/	chant les sons et noms des lettres/ les apostrophes/
amy Pierre trebor/ instruisãt les adolescẽs de son	amy Pierre trebor/ instruisant les adolescens de son
escole. Leq̃l certes est moult utile pour introduire	escole. Lequel certes est moult utile pour introduire
cte orthographie. Mais certes ie nay peu du tout	cte orthographie. Mais certes je n’ay peu du tout
reigles/ ⁊ aussi le recueil daucuns passages de le¬	reigles/ et aussi le recueil d’aucuns passages de l’e¬
scripture saincte ont este distraictz ⁊ perdus: exce¬	scripture saincte ont este distraictz et perdus: exce¬
rescou de la despouille. Lequel prẽdras en gre: attẽ	rescou de la despouille. Lequel prendras en gre: atten¬
dict frere ⁊ feal amy Pierre aura le tẽps ⁊ oportu¬	dict frere et feal amy Pierre aura le temps et oportu¬
nite de tout restituer. Laq̃lle chose nous attẽdõs de	nite de tout restituer. Laquelle chose nous attendons de
⁊ ne cõfond ceux qͥ esperent en luy. Tu auras	et ne confond ceux qui esperent en luy. Tu auras
point obserue la maniere descrire/	point observe la maniere d’escrire/
⁊ punctuer: par faute des	et punctuer: par faute des
presentement.	presentement.
tout.	tout.
De Genesue. 1533.	De Genesve. 1533.
En quoy corrigera ladolescent sa uoye?	En quoy corrigera l’adolescent sa voye?
Matth.19.b.	Matth.19.b.
Laissez uenir a moy les petis/ ⁊ ne les	Laissez venir a moy les petis/ et ne les
me des cieux.	me des cieux.
