¶ Les faictz de Iesus Christ ⁊ du Pape/ par lesquelz	¶ Les faictz de Jesus Christ et du Pape/ par lesquelz
chascun pourra facilement congnoistre la grãde difference de entre eulx: nouuel¬	chascun pourra facilement congnoistre la grande difference de entre eulx: nouvel¬
droictz canons/ par le lecteur du sainct Palais.	droictz canons/ par le lecteur du sainct Palais.
Quam male conueniant cum Christi pectore Iesu.	Quam male conveniant cum Christi pectore Jesu.
Pontificum mores: iste libellus habet.	Pontificum mores: iste libellus habet.
Hoc pius/ ⁊ lecto codice doctus eris.	Hoc pius/ et lecto codice doctus eris.
Lecteur tu uois/ les faictz de Iesus Christ	Lecteur tu vois/ les faictz de Jesus Christ
En ce liuret/ aussi les meurs du pape	En ce livret/ aussi les meurs du pape
Le Pape non: mais tout bien prent ⁊ happe.	Le Pape non: mais tout bien prent et happe.
priui	privi¬
legio	legio
stoli¬	stoli¬
¶ A tous ceulx qui liront Grace/ paix/ ⁊ salut de Dieu nostre pere par no¬	¶ A tous ceulx qui liront Grace/ paix/ et salut de Dieu nostre pere par no¬
stre Seigneur Iesus son vray filz/ qui soit habitãt au coeur dung chascun/	stre Seigneur Jesus son vray filz/ qui soit habitant au coeur d’ung chascun/
L	L¬
clair ⁊ si resplendissant quil ny a si aueugle/ quil ne uoye bien la grosse	clair et si resplendissant qu’il n’y a si aveugle/ qu’il ne voye bien la grosse
differẽce entre la clarte du Sauueur/ ⁊ les grosses tenebres du Pape/ en¬	difference entre la clarte du Sauveur/ et les grosses tenebres du Pape/ en¬
tres de lestat papisticque. Tellement quon tiendroit a bon droict celuy	tres de l’estat papisticque. Tellement qu’on tiendroit a bon droict celuy
point faict comme le Pape ⁊ les siens. Neantmoins la charite de nostre Seigneur con¬	point faict comme le Pape et les siens. Neantmoins la charite de nostre Seigneur con¬
trainct de comparer Iesus auec le Pape: non point pour affection mauuaise/ ou par ire/	trainct de comparer Jesus avec le Pape: non point pour affection mauvaise/ ou par ire/
de misericorde uueille tous illuminer/ tant le Pape que tous Euesques/ prestres/ moy¬	de misericorde vueille tous illuminer/ tant le Pape que tous Evesques/ prestres/ moy¬
Dieu/ estans sains en foy ⁊ uiuans tous purement. Car ne desirons que le salut dung	Dieu/ estans sains en foy et vivans tous purement. Car ne desirons que le salut d’ung
chascun: ⁊ que tous uiennent a la congnoissance de uerite/ priant tous qui ce liure lirõt/	chascun: et que tous viennent a la congnoissance de verite/ priant tous qui ce livre liront/
le monde crie contre le Pape ⁊ son esglise/ a cause des paouretez ⁊ ordures qui y sont: ⁊ ny	le monde crie contre le Pape et son esglise/ a cause des paovretez et ordures qui y sont: et n’y
che/ ou secretement en son coeur/ ⁊ mesme le Pape ⁊ les siens se congnoissent telz/ quilz	che/ ou secretement en son coeur/ et mesme le Pape et les siens se congnoissent telz/ qu’ilz
ont honte deulx mesmes/ ne cerchant que se cacher/ ⁊ aucunement soy entretenir/ par le	ont honte d’eulx mesmes/ ne cerchant que se cacher/ et aucunement soy entretenir/ par le
ceulx qui monstrent leur estat/ ⁊ a ce par tous moyens quil est possible de penser trauail¬	ceulx qui monstrent leur estat/ et a ce par tous moyens qu’il est possible de penser travail¬
gneue la racine du mal: pourtant quon ne regarde que la uie du Pape ⁊ des siens: car la	gneue la racine du mal: pourtant qu’on ne regarde que la vie du Pape et des siens: car la
plus part des hommes pensent que si le Pape ⁊ les siens uiuoyent selon leur estat/ selon	plus part des hommes pensent que si le Pape et les siens vivoyent selon leur estat/ selon
nonobstant que la uie ⁊ le train du Pape soit trespaoure ⁊ fort meschant/ beaucoup plus	nonobstant que la vie et le train du Pape soit tres paovre et fort meschant/ beaucoup plus
Affin donc quon congnoisse lestat du Pape en soy quel il est/ quelles sont ses ordonnan¬	Affin donc qu’on congnoisse l’estat du Pape en soy quel il est/ quelles sont ses ordonnan¬
ces/ sans faire mention des uies des Papes/ comme des fardemens/ enchanterie/ ⁊ tou¬	ces/ sans faire mention des vies des Papes/ comme des fardemens/ enchanterie/ et tou¬
auec sa fille propre Lucresse: de laquelle auoit la compaignie son frere le Duc de Ualen¬	avec sa fille propre Lucresse: de laquelle avoit la compaignie son frere le Duc de Valen¬
estoit fille/ femme/ ⁊ belle fille de Alexandre. Des meurtres et horribles effusions	estoit fille/ femme/ et belle fille de Alexandre. Des meurtres et horribles effusions
de sang de Iulle/ auec son yurongnerie et execrable paillardise/ ne de la gourmandi¬	de sang de Julle/ avec son yvrongnerie et execrable paillardise/ ne de la gourmandi¬
cides/ et aultres choses plus que diabolicques de Clement ne faisons mention.	cides/ et aultres choses plus que diabolicques de Clement ne faisons mention.
la saincte eglise quil a faict ⁊ commande. Et de lautre le Pape chief de leglise Rom¬	la saincte eglise qu’il a faict et commande. Et de l’autre le Pape chief de l’eglise Rom¬
maine ⁊ ses decretz ⁊ ordonnances: affin que les consciences craintiues/ qui ont pen¬	maine et ses decretz et ordonnances: affin que les consciences craintives/ qui ont pen¬
⁊ plus craint de passer les ordonnances papales/ que la loy de Dieu soyent deliurees de	et plus craint de passer les ordonnances papales/ que la loy de Dieu soyent delivrees de
suyuant iceluy seul/ ⁊ sarrestant a sa saincte parolle/ tellement que tout le monde deliure	suyvant iceluy seul/ et s’arrestant a sa saincte parolle/ tellement que tout le monde delivre
de lerreur ⁊ abusion papisticque/ delaissant uanite/ suyue la uerite/ retournant au uray	de l’erreur et abusion papisticque/ delaissant vanite/ suyve la verite/ retournant au vray
en uraye charite sans tuer ⁊ meurtrir lung laultre/ comme lon a faict iusques a present	en vraye charite sans tuer et meurtrir l’ung l’aultre/ comme l’on a faict jusques a present
tres tormentz par faulte de congnoistre Iesus ⁊ sa parolle: ⁊ ce a linstigation du Pape ⁊	tres tormentz par faulte de congnoistre Jesus et sa parolle: et ce a l’instigation du Pape et
des siens/ pour maintenir ses abominations ⁊ mauldictes ordonnances.	des siens/ pour maintenir ses abominations et mauldictes ordonnances.
tous uoyent ⁊ congnoissent la uerite/ le chemin de uie ⁊ de salut/ ⁊ que tous le tiennent	tous voyent et congnoissent la verite/ le chemin de vie et de salut/ et que tous le tiennent
de Dieu/ ⁊ edification lung de laultre/ tellement quen Leglise ny aye aultre chief que Ie¬	de Dieu/ et edification l’ung de l’aultre/ tellement qu’en L’eglise n’y aye aultre chief que Je¬
sus/ quon ne tienne aultre chose que ce quil a ordonne purement ⁊ simplement: ainsi que	sus/ qu’on ne tienne aultre chose que ce qu’il a ordonne purement et simplement: ainsi que
Le bon plaisir du Seigneur de tous/ qui tout a faict/ soit par sa bõte enuoyer par tou¬	Le bon plaisir du Seigneur de tous/ qui tout a faict/ soit par sa bonte envoyer par tou¬
la uerite/ comme le uray sauueur Iesus/ a cõmande sans y riens mesler/ faisant que tous	la verite/ comme le vray sauveur Jesus/ a commande sans y riens mesler/ faisant que tous
prennent la uerite/ ⁊ que tous soyõs amenez au troupeau de Iesus faictz tous ung trou¬	prennent la verite/ et que tous soyons amenez au troupeau de Jesus faictz tous ung trou¬
meine ⁊ conduise tous par le droict chemin iusques a la fin. Amen.	meine et conduise tous par le droict chemin jusques a la fin. Amen.
¶ Christ.	¶ Christ.
¶ Ie suis ung	¶ Je suis ung
me/ la derisiõ des	me/ la derision des
pris du peuple.	pris du peuple.
Psalm.21.	Psalm.21.
me nest point ue¬	me n’est point ve¬
uy: mais pour ser	vy: mais pour ser¬
uir. Mat.20.	vir. Mat.20.
neanty soymes¬	neanty soymes¬
forme du seruiteͬ/	forme du serviteur/
faict en la simili¬	faict en la simili¬
⁊ trouue en habit	et trouve en habit
humilie soymes¬	humilie soymes¬
mes/ ⁊ a este faict	mes/ et a este faict
la mort/ ⁊ la mort	la mort/ et la mort
¶ Pierre.	¶ Pierre.
¶ Christ a souf¬	¶ Christ a souf¬
uous laissant exemple: affin que ensuyuez ses uoyes. 1.Pet.2.	vous laissant exemple: affin que ensuyvez ses voyes. 1.Pet.2.
uons estime comme ung lepreux/ ⁊ auons este gueris par la basture diceluy. Esaye.53.	vons estime comme ung lepreux/ et avons este gueris par la basture d’iceluy. Esaye.53.
¶ Le Pape. ¶ Nous auos la seigneurie de toute la terre/ car a nous appartiẽt	¶ Le Pape. ¶ Nous avons la seigneurie de toute la terre/ car a nous appartient
Nemo aliorũ facta. Car nous auons tous les droictz cachez en larche de nostre coeur.	Nemo aliorum facta. Car nous avons tous les droictz cachez en l’arche de nostre coeur.
la. Nous sommes assis sur la chaire de p̃minẽce. de sepul. suꝑ ca. Tous princes romains	la. Nous sommes assis sur la chaire de preminence. de sepul. super ca. Tous princes romains
ont adore nr̃e siege. de iureiur. in Clemẽ. Roma. prin. ¶ Le Pape se dit seruus seruorũ:	ont adore notre siege. de jurejur. in Clemen. Roma. prin. ¶ Le Pape se dit servus servorum:
ment son hypocrisie/ ueu quil usurpe autorite sur tous. Et se faict appeller sanctissimus	ment son hypocrisie/ veu qu’il usurpe autorite sur tous. Et se faict appeller sanctissimus
ce nom des idolatres cõme Paulus pere de Aphricanus/ estoit appelle. Macrobius de	ce nom des idolatres comme Paulus pere de Aphricanus/ estoit appelle. Macrobius de
somno. Scipio. in princi.	somno. Scipio. in princi.
Regna fugit Christus.	Regna fugit Christus.
congneut que ilz debuoyent	congneut que ilz debvoyent
uenir pour le prendre/ et le	venir pour le prendre/ et le
tira seul en la montaigne.	tira seul en la montaigne.
¶ Mõ Royaulme nest pas	¶ Mon Royaulme n’est pas
de ce monde. Ioan.18.	de ce monde. Joan.18.
dominatiõ sur eulx/ ⁊ ceulx	domination sur eulx/ et ceulx
sont nommez biẽsfaicteurs:	sont nommez biensfaicteurs:
mais il nest point ainsi de	mais il n’est point ainsi de
luy qui precede comme le seruiteur. Car lequel est le plus grand/ celuy qui est assis a ta¬	luy qui precede comme le serviteur. Car lequel est le plus grand/ celuy qui est assis a ta¬
uous comme celuy qui sert. Luc.22.	vous comme celuy qui sert. Luc.22.
¶ Le diable le transporta sur une montaigne fort haulte/ ⁊ luy mõstra tous les Royaul¬	¶ Le diable le transporta sur une montaigne fort haulte/ et luy monstra tous les Royaul¬
prosternant tu me adores. Adoncques Iesus luy dit. Ua Sathan: car il est escript. Tu	prosternant tu me adores. Adoncques Jesus luy dit. Va Sathan: car il est escript. Tu
¶ Et aucun luy dit. Maistre dis a mon frere quil partisse auec moy lheritaige. Et il luy	¶ Et aucun luy dit. Maistre dis a mon frere qu’il partisse avec moy l’heritaige. Et il luy
dist. Homme qui ma constitue iuge ou partisseur sur uous. Luce.12.	dist. Homme qui ma constitue juge ou partisseur sur vous. Luce.12.
mais seulement est apres la predication/ ⁊ a soulagier le peuple: ⁊ pour deffense quelcon¬	mais seulement est apres la predication/ et a soulagier le peuple: et pour deffense quelcon¬
La ou le Pape ne tache que faire sa uolunte/ repugner a Dieu ⁊ aux princes ausquelz	La ou le Pape ne tache que faire sa volunte/ repugner a Dieu et aux princes ausquelz
par ses droictz il doibt estre subiect. distin.8. quo iure. distin.9. imperatores.	par ses droictz il doibt estre subject. distin.8. quo jure. distin.9. imperatores.
Sed presul suscipit	Sed presul suscipit
¶ Le Pape excom¬	¶ Le Pape excom¬
munie toꝰ uicaires/	munie tous vicaires/
se de Lempire si du	se de L’empire si du
laissantz tout ce qͥlz	laissantz tout ce qu’ilz
tiennent/ cassant toꝰ	tiennent/ cassant tous
faictz du peuple a i¬	faictz du peuple a i¬
plus a plein quon re¬	plus a plein qu’on re¬
garde le chapitr. Si	garde le chapitre. Si
pape Iehã.xxii. Ne	pape Jehan.xxii. Ne
nouet̃ extrauag. Si	novet̃ extravag. Si
de fratrũ. Et oyez en	de fratrũ. Et oyez en
gnifie/ ⁊ aneantist la	gnifie/ et aneantist la
reur/ disant: Nous sans doubte auons superiorite sur Lempire/ ⁊ iceluy uacant	reur/ disant: Nous sans doubte avons superiorite sur L’empire/ et iceluy vacant
nous luy succedons/ ayans plenitude de puissance/ laquelle le Roy des roys/ ⁊ le	nous luy succedons/ ayans plenitude de puissance/ laquelle le Roy des roys/ et le
iect iusticiable/ ⁊ nostre uassal/ tenant de nous son Royaulme ⁊ terres. in Clemen	ject justiciable/ et nostre vassal/ tenant de nous son Royaulme et terres. in Clemen¬
pire doccidẽt/ la courõne/ ⁊ le mãteau de pourpre/ ⁊ tout ce que appartiẽt a la digni¬	pire d’occident/ la couronne/ et le manteau de pourpre/ et tout ce que appartient a la digni¬
te Imperiale. 12.q.1. Futuram. ⁊ dist.96. Cõstãtinus. Les Empereurs doibuent	te Imperiale. 12.q.1. Futuram. et dist.96. Constantinus. Les Empereurs doibvent
p̃stres sõt maistres ⁊ peres des princes. dist.96. Quis dubitet. ¶ Regardez chre¬	prestres sont maistres et peres des princes. dist.96. Quis dubitet. ¶ Regardez chre¬
⁊ Seigneurs/ ⁊ leur oster le glaiue/ leq̃l Dieu leur a dõne/ cõme S. Paul dit aux	et Seigneurs/ et leur oster le glaive/ lequel Dieu leur a donne/ comme Sainct Paul dit aux
Rõmains.13. pour accomplir ce que dit S. Pierre/ que se sont auteurs de sectes/ cõ¬	Rommains.13. pour accomplir ce que dit Sainct Pierre/ que se sont auteurs de sectes/ com¬
garde la uie de Boniface .uiii. cõme il sest porte enuers les Empereurs/ ⁊ la uie de	garde la vie de Boniface .viii. comme il s’est porte envers les Empereurs/ et la vie de
destruire Lẽpire? cõbien tous les Papes ont este a Lẽpire? ⁊ les grandz tors qͥlz	destruire L’empire? combien tous les Papes ont este a L’empire? et les grandz tors qu’ilz
ont faict aux droictz ⁊ naturelz seigñrs leurs ostãt leurs seigneuries ⁊ royaulmes/	ont faict aux droictz et naturelz seigneurs leurs ostant leurs seigneuries et royaulmes/
uoꝰ yeulx de recõgnoistre celuy qui cõmande quon uoꝰ rende ce quon uoꝰ doibt/ ne	vous yeulx de recongnoistre celuy qui commande qu’on vous rende ce qu’on vous doibt/ ne
Iesus despine si est couronne piteusement.	Jesus d’espine si est couronne piteusement.
Spinosam Christus.	Spinosam Christus.
na point pleu a soy¬	n’a point pleu a soy¬
quil est escript. Les	qu’il est escript. Les
opprobres de ceulx	opprobres de ceulx
sont cheuz sur moy.	sont cheuz sur moy.
¶ Les gensdarmes	¶ Les gensdarmes
du preuost prindrent	du prevost prindrent
assemblerent deuant	assemblerent devant
de/ ⁊ le deuestirent et	de/ et le devestirent et
luy mirẽt au tour de	luy mirent au tour de
pourpre/ ⁊ ployerent	pourpre/ et ployerent
nes: ⁊ la mirent sur	nes: et la mirent sur
son chief/ ⁊ ung rouseau en sa main dextre/ ⁊ se agenouilloyent deuant luy/ ⁊ se	son chief/ et ung rouseau en sa main dextre/ et se agenouilloyent devant luy/ et se
drent ung roseau ⁊ frappoyent son chief. Matth.27.	drent ung roseau et frappoyent son chief. Matth.27.
stu dung uestement blanc/ ⁊ le renuoya a Pilate. Luce.23.	stu d’ung vestement blanc/ et le renvoya a Pilate. Luce.23.
¶ Chrestiens ie uous prie retournez uous a ce tresdoulx ⁊ tresbening Sauueur	¶ Chrestiens je vous prie retournez vous a ce tres doulx et tres bening Sauveur
grosse angoisse ⁊ paourete. Helas que uous a il faict que uous ne uenez a luy/ qui	grosse angoisse et paovrete. Helas que vous a il faict que vous ne venez a luy/ qui
scauroit dire ne exprimer/ le uoulez uous contemner ⁊ laisser pour retourner a ly¬	scauroit dire ne exprimer/ le voulez vous contemner et laisser pour retourner a l’y¬
dole de Rõme. Helas il y a bien choys/ Christ uient pour uiuifier/ ⁊ le Pape pour	dole de Romme. Helas il y a bien choys/ Christ vient pour vivifier/ et le Pape pour
Pape uous deuore/ Christ doulx ⁊ pitoyable a contempler/ Le Pape est fier ⁊ or¬	Pape vous devore/ Christ doulx et pitoyable a contempler/ Le Pape est fier et or¬
de uostre mort. Et uous le suyuez en delaissant celuy qui pour uoꝰ a souffert tous	de vostre mort. Et vous le suyvez en delaissant celuy qui pour vous a souffert tous
opprobres ⁊ maulx/ affin que uoꝰ triumphissiez ⁊ eussiez le Royaulme eternel/ Le¬	opprobres et maulx/ affin que vous triumphissiez et eussiez le Royaulme eternel/ Le¬
Et le pape de pierrerie ⁊ or sumptueusement.	Et le pape de pierrerie et or sumptueusement.
¶ Quel orgueil/ quelle põ¬	¶ Quel orgueil/ quelle pom¬
pe/ quelle boubance peult e¬	pe/ quelle boubance peult e¬
a son uestement ⁊ son coron¬	a son vestement et son coron¬
paillarde? de laquelle est dit	paillarde? de laquelle est dit
quelle estoit assise sur une be	qu’elle estoit assise sur une be¬
blasphemes? laquelle estoit	blasphemes? laquelle estoit
carlate/ ⁊ doree dor ⁊ de pier¬	carlate/ et doree d’or et de pier¬
res precieuses/ ⁊ de margue¬	res precieuses/ et de margue¬
calice dor plain dabomina¬	calice d’or plain d’abomina¬
nicatiõ? Elle ua a perditiõ:	nication? Elle va a perdition:
⁊ se esmerueilleront les habi	et se esmerveilleront les habi¬
point escriptz au liure de la	point escriptz au livre de la
manteau de pourpre ⁊ aultres abillemens imperiaulx/ comme il appert. distinc.96. Cõ¬	manteau de pourpre et aultres abillemens imperiaulx/ comme il appert. distinc.96. Con¬
stantinus. Non obstant que iamais Empereur neust telle coronne/ ne telz abillemẽs que	stantinus. Non obstant que jamais Empereur n’eust telle coronne/ ne telz abillemens que
me sainct pere ⁊ Dieu en terre. Comment ne regarde lon ce qui est dit de tenir le lieu des	me sainct pere et Dieu en terre. Comment ne regarde l’on ce qui est dit de tenir le lieu des
cret. distinc.40. Non est facile. Il fault faire comme S. Pierre qui ueult estre son succes¬	cret. distinc.40. Non est facile. Il fault faire comme Sainct Pierre qui veult estre son succes¬
seur/ aultrement qui faict comme Iudas/ Anne/ ⁊ Caiphe/ ⁊ Simon magus: il est leur	seur/ aultrement qui faict comme Judas/ Anne/ et Caiphe/ et Simon magus: il est leur
ayment mensonge son filz du diable/ non seulement en parolles: mais aussi en faictz/ cest	ayment mensonge son filz du diable/ non seulement en parolles: mais aussi en faictz/ c’est
re le contraire. 22.q.5. Cauete fratres. Ne uoit on pas que tout condemne lestat du Pa	re le contraire. 22.q.5. Cavete fratres. Ne voit on pas que tout condemne l’estat du Pa¬
pe/ puis quil ce dit successeur de Iesus ⁊ de Pierre/ ⁊ ne tient rien de eulx: mais leur est	pe/ puis qu’il ce dit successeur de Jesus et de Pierre/ et ne tient rien de eulx: mais leur est
Pierre? Rien.	Pierre? Rien.
Abluit ille pedes.	Abluit ille pedes.
¶ Il fault Chrestiens que	¶ Il fault Chrestiens que
car il est la lumiere du mon	car il est la lumiere du mon¬
poĩt en tenebres/ mais a la	point en tenebres/ mais a la
lumiere de uie. Ioan.8.	lumiere de vie. Joan.8.
ayme/ lequel le Pere nous	ayme/ lequel le Pere nous
¶ Pour uray ainsi quil a la	¶ Pour vray ainsi qu’il a la¬
ue les piedz de ses apostres:	ve les piedz de ses apostres:
humiliãt/ poͬ nous a souf¬	humiliant/ pour nous a souf¬
ure malfaicteur/ combien	vre malfaicteur/ combien
quil neut iamais faict mal/ pourtant delaissant tout/ allons a luy par uraye foy/ tenans	qu’il n’eut jamais faict mal/ pourtant delaissant tout/ allons a luy par vraye foy/ tenans
¶ Si doncques moy Seigneur ⁊ maistre ay laue uoz piedz/ uous debuez aussi lauer les	¶ Si doncques moy Seigneur et maistre ay lave voz piedz/ vous debvez aussi laver les
faict. En uerite/ en uerite ie uous dis/ que le seruiteur nest point plus grand que son sei¬	faict. En verite/ en verite je vous dis/ que le serviteur n’est point plus grand que son sei¬
gneur/ ne Lapostre/ que celuy qui lenuoye. Si uous scauez ces choses/ uous serez bien¬	gneur/ ne L’apostre/ que celuy qui l’envoye. Si vous scavez ces choses/ vous serez bien¬
¶ Aprenez de moy que ie suis debonnaire ⁊ humble de coeur. Matthe.11.	¶ Aprenez de moy que je suis debonnaire et humble de coeur. Matthe.11.
¶ Sentez en uous ce qui a este en Iesus Christ/ lequel comme ainsi fut quil estoit en la	¶ Sentez en vous ce qui a este en Jesus Christ/ lequel comme ainsi fut qu’il estoit en la
forme de Dieu il na point repute larrecin estre esgal a Dieu: mais il sest aneanty soymes¬	forme de Dieu il n’a point repute larrecin estre esgal a Dieu: mais il s’est aneanty soymes¬
comme homme. Il sest humilie soymesmes/ ⁊ a este faict obedient iusques a la mort/ uoy¬	comme homme. Il s’est humilie soymesmes/ et a este faict obedient jusques a la mort/ voy¬
Mais ceulx du pape par les Roys sont baisez.	Mais ceulx du pape par les Roys sont baisez.
Reges his oscula prebent.	Reges his oscula prebent.
nation faire ce q̃ le Pape dit	nation faire ce que le Pape dit
te humaine creature soit sub	te humaine creature soit sub¬
iecte au pontife de Rõme/ le	jecte au pontife de Romme/ le¬
sus/ duq̃l il est uicaire ayant	sus/ duquel il est vicaire ayant
tuel ⁊ temporel/ qui doibt iu¬	tuel et temporel/ qui doibt ju¬
ger de tous/ ⁊ personne ne	ger de tous/ et personne ne
maioritate et obedi. unam	majoritate et obedi. unam
se na q̃ ung chief/ cest Iesus	se n’a que ung chief/ c’est Jesus
Christ: ⁊ il se dit estre chief/	Christ: et il se dit estre chief/
ou q̃ leglise aye deux chiefz/	ou que l’eglise aye deux chiefz/
ne lest point/ ⁊ si Iesus est	ne l’est point/ et si Jesus est
chief/ le Pape ne le peult	chief/ le Pape ne le peult
¶ Ilz ont adore la beste/ disans: Qui est semblable a la beste/ a laq̃lle a este donnee gueu¬	¶ Ilz ont adore la beste/ disans: Qui est semblable a la beste/ a laquelle a este donnee gueu¬
nacle/ ⁊ ceulx qui habitent au ciel/ ⁊ luy a este donne de batailler contre les sainctz/ ⁊ les	nacle/ et ceulx qui habitent au ciel/ et luy a este donne de batailler contre les sainctz/ et les
uaincre/ ⁊ tous ceulx qui habitent en la terre lont adore/ desquelz les noms ne sont point	vaincre/ et tous ceulx qui habitent en la terre l’ont adore/ desquelz les noms ne sont point
de la beste/ ou le nombre de son nom. Apoca.13. ¶ Ceste orgueilleuse fasson de faire bai¬	de la beste/ ou le nombre de son nom. Apoca.13. ¶ Ceste orgueilleuse fasson de faire bai¬
de Lucien in Nigrino/ ⁊ faict mention de ce baisemens en ses canons. De priuile. cleri.	de Lucien in Nigrino/ et faict mention de ce baisemens en ses canons. De privile. cleri.
cum olim. ⁊ in Clementi. de sentẽ. excõmu. Si summus ponti. ¶ Sainct Pierre uray	cum olim. et in Clementi. de sentẽ. excõmu. Si summus ponti. ¶ Sainct Pierre vray
qͥl se lieue/ disant: ie suis hõme. Act.10. ¶ Et S. Paul/ ⁊ Barnabas aussi ne souffrent	qu’il se lieve/ disant: je suis homme. Act.10. ¶ Et Sainct Paul/ et Barnabas aussi ne souffrent
mes qui iamais fussent/ se font adorer mesmes des haultes puissances de ceulx qui ont le	mes qui jamais fussent/ se font adorer mesmes des haultes puissances de ceulx qui ont le
nom de Dieu. Psal.81. O cecite/ o horrible ydolatrie. Il y a sept baisiers du Pape: a la	nom de Dieu. Psal.81. O cecite/ o horrible ydolatrie. Il y a sept baisiers du Pape: a la
luy baise les piedz auant quil lise Leuangille/ ⁊ le souldiacre apres auoir leu lepistre.	luy baise les piedz avant qu’il lise L’euangille/ et le souldiacre apres avoir leu l’epistre.
Uectigal soluit.	Vectigal soluit.
¶ Rẽdez a Cesar ce qui est	¶ Rendez a Cesar ce qui est
a Dieu. Matth.22.	a Dieu. Matth.22.
humaine creature poͬ dieu/	humaine creature pour dieu/
soit au Roy comme au plus	soit au Roy comme au plus
me aux enuoyez de par luy	me aux envoyez de par luy
malfaicteurs/ ⁊ poͬ la louen	malfaicteurs/ et pour la louen¬
ge des bons. 1.Pet.2.	ge des bons. 1.Pet.2.
iectz en toute crainte a uoz	jectz en toute crainte a voz
aux bons ⁊ modestes/ mais	aux bons et modestes/ mais
aussi aux difficiles. 1.Pet.2.	aussi aux difficiles. 1.Pet.2.
ras ouuert la gorge/ tu trouueras une statere/ prens la/ ⁊ la donne pour moy ⁊ pour toy.	ras ouvert la gorge/ tu trouveras une statere/ prens la/ et la donne pour moy et pour toy.
le glaiue sans cause. Rendez dõcques a tous les choses deues/ a qui tribut/ le tribut/ a qui	le glaive sans cause. Rendez doncques a tous les choses deues/ a qui tribut/ le tribut/ a qui
crainte/ la crainte/ a qui honneur lhonneur. Rom.13.	crainte/ la crainte/ a qui honneur l’honneur. Rom.13.
re/ ne de ce que parauant a este ordonne: mais pour son proffit il change tout ⁊ ordonne	re/ ne de ce que paravant a este ordonne: mais pour son proffit il change tout et ordonne
pereurs/ ausquelz il fault obeir. distĩ.8. Quo iure. Celuy qui ne obeist aux loix des Em¬	pereurs/ ausquelz il fault obeir. distin.8. Quo jure. Celuy qui ne obeist aux loix des Em¬
pereurs/ il acqueste ung grand tormẽt. dist.9. imperatores. Ainsi est dit quil fault garder	pereurs/ il acqueste ung grand torment. dist.9. imperatores. Ainsi est dit qu’il fault garder
stram. Les possessions de Leglise payẽt tribut a Lempereur. 11.q.1. Si tributum. 23.q.8.	stram. Les possessions de L’eglise payent tribut a L’empereur. 11.q.1. Si tributum. 23.q.8.
destre subiectz aux puissances souueraines/ affin que personne ne pense que la constitu¬	d’estre subjectz aux puissances souveraines/ affin que personne ne pense que la constitu¬
tion du Roy terrien doibue estre rompue. Car si le filz de Dieu a paye la cense/ qui es tu	tion du Roy terrien doibve estre rompue. Car si le filz de Dieu a paye la cense/ qui es tu
quãd il ne cõmande chose contraire a la saincte Escripture. 11.qõ.3. Si dominus.	quand il ne commande chose contraire a la saincte Escripture. 11.qõ.3. Si dominus.
Sed cleros eximit	Sed cleros eximit
omnes.	omnes.
gnent/ que les laiz sont en¬	gnent/ que les laiz sont en¬
uoyons par experience: et	voyons par experience: et
pourtant nous deffendons	pourtant nous deffendons
Roys/ ou Barõs/ ou de q̃l¬	Roys/ ou Barons/ ou de quel¬
nayent a exiger du clerge/	n’ayent a exiger du clerge/
ne des ecclesiasticques/ ne	ne des ecclesiasticques/ ne
chose quelconque/ soit en	chose quelconque/ soit en
en quelque maniere quil soit/ tant pour leurs personnes/ que pour leurs bien acquis/ ou	en quelque maniere qu’il soit/ tant pour leurs personnes/ que pour leurs bien acquis/ ou
quen apres il acquesteront/ sur la peine de excommuniement/ tant a ceulx qui exigeront/	qu’en apres il acquesteront/ sur la peine de excommuniement/ tant a ceulx qui exigeront/
Et il dit que les Empereurs doibuẽt estre subiectz a luy/ ⁊ non pas luy aux Empereurs.	Et il dit que les Empereurs doibvent estre subjectz a luy/ et non pas luy aux Empereurs.
canons ⁊ decretz: uoyre aussi destruisant ses decretz mesmes. Dont luy uient ceste auda¬	canons et decretz: voyre aussi destruisant ses decretz mesmes. Dont luy vient ceste auda¬
ce de uouloir exempter les siens/ ⁊ soy faire iuge/ uoire de tous? ueu quil ne doibt estre iu¬	ce de vouloir exempter les siens/ et soy faire juge/ voire de tous? veu qu’il ne doibt estre ju¬
doibuent estre subiectz aux princes/ ⁊ payer cõme les aultres/ comme S. Paul. Rom̃.13.	doibvent estre subjectz aux princes/ et payer comme les aultres/ comme Sainct Paul. Rom̃.13.
le prince a puissance sur les corps du Pape ⁊ des siens: car il est dit/ le Roy doibt refrener	le prince a puissance sur les corps du Pape et des siens: car il est dit/ le Roy doibt refrener
les larrecins/ punir les adulteres ⁊ les meschans exterminer de la terre. 23.q.5. Rex de¬	les larrecins/ punir les adulteres et les meschans exterminer de la terre. 23.q.5. Rex de¬
dẽfans/ une paoure uefue payera grosse taille/ ⁊ ces putiers de prestres/ ces gras moynes/	d’enfans/ une paovre vefve payera grosse taille/ et ces putiers de prestres/ ces gras moynes/
⁊ les pierres/ tant en ont/ sont francz/ ⁊ quelque mal quilz facent ne seront reprins de la	et les pierres/ tant en ont/ sont francz/ et quelque mal qu’ilz facent ne seront reprins de la
iustice: mais supportez.	justice: mais supportez.
Languores sanat.	Languores sanat.
ple uenoit poͬ louyr/ ⁊ pour	ple venoit pour l’ouyr/ et pour
estre gueris de leurs mala¬	estre gueris de leurs mala¬
xez des esperitz immõdes/	xez des esperitz immondes/
multitude q̃roit le toucher:	multitude queroit le toucher:
car uertu yssoit de luy/ ⁊ gue	car vertu yssoit de luy/ et gue¬
¶ Ilz luy presenterent plu¬	¶ Ilz luy presenterent plu¬
ta hors les esperitz par la pa	ta hors les esperitz par la pa¬
rolle/ ⁊ guerist tous les ma¬	rolle/ et guerist tous les ma¬
ply ce qui estoit dit par le pro	ply ce qui estoit dit par le pro¬
a prins sur soy noz infirmitez/ ⁊ a porte noz maladies. Matthe.8.	a prins sur soy noz infirmitez/ et a porte noz maladies. Matthe.8.
¶ Il guerist plusieurs de leurs maladies ⁊ playes/ ⁊ des mauuais esperitz/ ⁊ rẽdit la ueue	¶ Il guerist plusieurs de leurs maladies et playes/ et des mauvais esperitz/ et rendit la veue
uez ueu ⁊ ouy/ les aueugles receoyuent la ueue/ ⁊ les boyteux cheminent/ les ladres sont	vez veu et ouy/ les aveugles receoyvent la veue/ et les boyteux cheminent/ les ladres sont
message de Leuangille. Luce.7.	message de L’evangille. Luce.7.
¶ Il nest aultre mention par tout fors comment le Sauueur a ayde aux paoures mala¬	¶ Il n’est aultre mention par tout fors comment le Sauveur a ayde aux paovres mala¬
guerissent les malades sans rien prẽdre/ ne uoulant quon face mal a personne: mais mes¬	guerissent les malades sans rien prendre/ ne voulant qu’on face mal a personne: mais mes¬
Iacques uouloyent que le feu descendit pour brusler ceulx qui auoyent ferme les portes	Jacques vouloyent que le feu descendit pour brusler ceulx qui avoyent ferme les portes
contre Iesus/ pourtant quil alloit en Hierusalem/ ne dit il pas quilz ne scauoyent de quel	contre Jesus/ pourtant qu’il alloit en Hierusalem/ ne dit il pas qu’ilz ne scavoyent de quel
¶ Ainsi cõmande a Pierre qui cache son couteau/ ⁊ nous monstrant exemple il prie pour	¶ Ainsi commande a Pierre qui cache son couteau/ et nous monstrant exemple il prie pour
Lorgueil du pape sesiouyt en occision.	L’orgueil du pape s’esjouyt en occision.
Effuso hic sanguine gaudet.	Effuso hic sanguine gaudet.
maieste faict ioustes/ ⁊ aul¬	majeste faict joustes/ et aul¬
urement meurent/ car sil e¬	vrement meurent/ car s’il e¬
stoit bening ⁊ pitoyable aux	stoit bening et pitoyable aux
bis/ il en seroit mesprise/ cõ¬	bis/ il en seroit mesprise/ com¬
liarite engendre mespris. di	liarite engendre mespris. di¬
stinc.86. Quãdo. ⁊ la glosse	stinc.86. Quando. et la glosse
comme sont simples gens	comme sont simples gens
gẽt pour ung peu de papier/	gent pour ung peu de papier/
ou de perchemin/ que le Pa¬	ou de perchemin/ que le Pa¬
ce quil cõmãde ⁊ tremblans	ce qu’il commande et tremblans
q̃ son decret dit de luy ⁊ des	que son decret dit de luy et des
siens qui uiuent ainsi q̃ luy.	siens qui vivent ainsi que luy.
regime il nest point Euesque/ mais chien impudicque. 11.qõ.3. Qui nec. distinc.5. Non	regime il n’est point Evesque/ mais chien impudicque. 11.qõ.3. Qui nec. distinc.5. Non
il ne cherchera ce qui est esgare/ ⁊ ce qui est froisse il ne le guerira point/ ⁊ ne entretiendra	il ne cherchera ce qui est esgare/ et ce qui est froisse il ne le guerira point/ et ne entretiendra
point cela qͥ est sain ⁊ mangera la chair grasse/ ⁊ il destruira les ungles dicelles. Zac.11.	point cela qui est sain et mangera la chair grasse/ et il destruira les ungles dicelles. Zac.11.
mour delle le sang humain soit espãdu/ quon se tue lung lautre/ helas que peult il estime	mour d’elle le sang humain soit espandu/ qu’on se tue l’ung l’autre/ helas que peult il estime
ung larron ne uient sinon pour tuer/ perdre ⁊ destruire. Ioan.10.	ung larron ne vient sinon pour tuer/ perdre et destruire. Joan.10.
¶ Ses decretz ne deffendent ilz que les ioustes ne soyent faictes? de torneamẽtis. c. feli¬	¶ Ses decretz ne deffendent ilz que les joustes ne soyent faictes? de torneamentis. c. feli¬
cura. significatum. Et non seulemẽt ces ieux meurtriers: mais la chasse luy est deffendue.	cura. significatum. Et non seulement ces jeux meurtriers: mais la chasse luy est deffendue.
toutes uoluptez/ pompes/ ⁊ uanitez. Et les prestres ⁊ ecclesiasticques qui sont au lieu ou	toutes voluptez/ pompes/ et vanitez. Et les prestres et ecclesiasticques qui sont au lieu ou
sentence de mort est donnee / ou en lieu auquel aucun aultrement par sentence est mis a	sentence de mort est donnee / ou en lieu auquel aucun aultrement par sentence est mis a
cra. distĩ.5. Non oportet. Mais qui sont sur la terre plus põpeux/ plus adonne a ieux/ a	cra. distin.5. Non oportet. Mais qui sont sur la terre plus pompeux/ plus adonne a jeux/ a
Iesus porte la croix en grand douleur.	Jesus porte la croix en grand douleur.
Baiulat ille crucem.	Bajulat ille crucem.
du chemin. Ioan.4.	du chemin. Joan.4.
moy renonce soymesmes/ ⁊	moy renonce soymesmes/ et
porte sa croix/ ⁊ me suyue.	porte sa croix/ et me suyve.
¶ Ilz prindrẽt Iesꝰ/ ⁊ le me¬	¶ Ilz prindrent Jesus/ et le me¬
sa croix allant au lieu qͥ est	sa croix allant au lieu qui est
nõme Caluaire. Io.19.	nomme Calvaire. Jo.19.
noz langueurs/ il a porte	noz langueurs/ il a porte
estime frappe de dieu/ ⁊ hu¬	estime frappe de dieu/ et hu¬
milie: cõbien que pour noz	milie: combien que pour noz
⁊ pour noz iniquitez il soit	et pour noz iniquitez il soit
est sur luy/ ⁊ par sa basture	est sur luy/ et par sa basture
noꝰ sõmes gueris. Esa.53.	nous sommes gueris. Esa.53.
de seras tu tousioͬs endor¬	de seras tu tousjours endor¬
grande ingratitude ⁊ mescõgnoissance dauoir delaisse tõ sauueur/ sa parolle/ ses sainctes	grande ingratitude et mescongnoissance d’avoir delaisse ton sauveur/ sa parolle/ ses sainctes
ordõnances pour recepuoir ⁊ toy submettre au meschant larron/ ⁊ brigãt Barrabas/ qui	ordonnances pour recepvoir et toy submettre au meschant larron/ et brigant Barrabas/ qui
qͥ sont charges importables/ receu as ces ceremonies ⁊ fassons / qͥ sont choses dãnables/	qui sont charges importables/ receu as ces ceremonies et fassons / qui sont choses damnables/
luy/ ⁊ ce quil a ordonne/ ⁊ tu auras repos en ton ame. ¶ Biẽheureux serez uoꝰ quãd les	luy/ et ce qu’il a ordonne/ et tu auras repos en ton ame. ¶ Bienheureux serez vous quand les
hõmes uous aurõt eu en hayne/ ⁊ uoꝰ aurõt separez/ ⁊ uous aurõt faict iniures/ ⁊ auront	hommes vous auront eu en hayne/ et vous auront separez/ et vous auront faict injures/ et auront
la/ ⁊ soyez en exultation: car uoicy uostre loyer est grãd au ciel. Certes telles choses fai¬	la/ et soyez en exultation: car voicy vostre loyer est grand au ciel. Certes telles choses fai¬
bienheureux: car ainsi faisoyent leurs peres aux faulx prophetes. Luc.6. ¶ Le disciple	bienheureux: car ainsi faisoyent leurs peres aux faulx prophetes. Luc.6. ¶ Le disciple
nest point par dessus son maistre: ne le seruiteur par dessus son seigñr. Il souffist au disci	n’est point par dessus son maistre: ne le serviteur par dessus son seigneur. Il souffist au disci¬
de famille Beelzebub/ cõbien plus ses domesticques? Matth.10. ¶ Courons par pa¬	de famille Beelzebub/ combien plus ses domesticques? Matth.10. ¶ Courons par pa¬
pour ioye a luy proposee endura la croix en desprisant confusion/ ⁊ est assis a la dextre du	pour joye a luy proposee endura la croix en desprisant confusion/ et est assis a la dextre du
siege de Dieu. Mais pẽsez ⁊ repẽsez celuy qͥ a souffert telle cõtradictiõ des pecheurs a len	siege de Dieu. Mais pensez et repensez celuy qui a souffert telle contradiction des pecheurs a l’en¬
Le pape est porte en grand honneur.	Le pape est porte en grand honneur.
¶ Le pape est le chief ⁊ le	¶ Le pape est le chief et le
gon des aultres eglises: car	gon des aultres eglises: car
nee par le gon/ ainsi de son	nee par le gon/ ainsi de son
eglises sont gouuernees. Il	eglises sont gouvernees. Il
est appelle pere des peres/	est appelle pere des peres/
prince sur toute leglise/ ⁊ est	prince sur toute l’eglise/ et est
sur tous les põtifes/ duquel	sur tous les pontifes/ duquel
cõme de la teste iceulx cõme	comme de la teste iceulx comme
nitude/ duq̃l tous prẽnent/	nitude/ duquel tous prennent/
tie de soing/ non point a la	tie de soing/ non point a la
plenitude de puissance. Ce	plenitude de puissance. Ce¬
loffice nest cõpare aux aul¬	l’office n’est compare aux aul¬
norũ officiorũ. de ministris.	norum officiorum. de ministris.
le cõtraire est Ephe.4. Co¬	le contraire est Ephe.4. Co¬
Io.1. Heb.5. ¶ O pasteur idole delaissant le troupeau/ le glaiue sur le bras diceluy/ sur	Jo.1. Heb.5. ¶ O pasteur idole delaissant le troupeau/ le glaive sur le bras d’iceluy/ sur
obscurcy. Zacha.11. ¶ Ceste idole ne se faict elle pas porter comme le S. Prophete Hiere¬	obscurcy. Zacha.11. ¶ Ceste idole ne se faict elle pas porter comme le Sainct Prophete Hiere¬
mie recite des idoles. Hiere.10. ⁊ tant seslieue quil dist nestre point homme: mais plus	mie recite des idoles. Hiere.10. et tant s’eslieve qu’il dist n’estre point homme: mais plus
leux chapitre. Et aussi la glose du proeme des clemẽtines/ qui cõmẽce Ioãnes/ la ou il dit/	leux chapitre. Et aussi la glose du proeme des clementines/ qui commence Joannes/ la ou il dit/
est Dieu ⁊ hõme/ ⁊ le pape nest Dieu ne homme/ il est dõc du tout cõtraire a Iesus/ ⁊ uray	est Dieu et homme/ et le pape n’est Dieu ne homme/ il est donc du tout contraire a Jesus/ et vray
Antechrist/ ⁊ ung droict diable. ¶ Chrestiens pour lhõneur de Iesus regardez ce pape	Antechrist/ et ung droict diable. ¶ Chrestiens pour l’honneur de Jesus regardez ce pape
peine qͥl ordõne cõtre ceulx qͥ font q̃lque chose cõtre ses cardinaulx ou legatz/ cõme in .ui.	peine qu’il ordonne contre ceulx qui font quelque chose contre ses cardinaulx ou legatz/ comme in .vi.
seulemẽt pour deffendre le pape ⁊ les siens: affin quilz nayent aucune croix en ce monde:	seulement pour deffendre le pape et les siens: affin qu’ilz n’ayent aucune croix en ce monde:
mais que tous les adorẽt ⁊ leur seruẽt cõme a Dieu. ¶ Quãd ceste idole est portee ses ba¬	mais que tous les adorent et leur servent comme a Dieu. ¶ Quand ceste idole est portee ses ba¬
nediction/ cest au signe de la croix quil faict de la main/ cõme si benedicere ⁊ benedictio/	nediction/ c’est au signe de la croix qu’il faict de la main/ comme si benedicere et benedictio/
du pape/ des euesques/ ⁊ de tout le mõde ainsi abuse. Et si aucun ne se met a genoulx il se¬	du pape/ des evesques/ et de tout le monde ainsi abuse. Et si aucun ne se met a genoulx il se¬
ra frappe/ ⁊ sil dit qͥl ne ueult adorer la beste/ il sera brusle. O Iesus uray filz de Dieu: ⁊	ra frappe/ et s’il dit qu’il ne veult adorer la beste/ il sera brusle. O Jesus vray filz de Dieu: et
uous ont dit uoire faict. Helas uous faisiez prieres pour uoz ennemys/ la ou le Pape ⁊	vous ont dit voire faict. Helas vous faisiez prieres pour voz ennemys/ la ou le Pape et
strent les abus ⁊ paouretez qui sont sur la terre.	strent les abus et paovretez qui sont sur la terre.
Iesus donne a ses brebis la pasture.	Jesus donne a ses brebis la pasture.
¶ Le doulx sauueur en tou	¶ Le doulx sauveur en tou¬
en lieu/ en tornant uilles ⁊	en lieu/ en tornant villes et
uillages ⁊ par tous lieux/	villages et par tous lieux/
re laissant le boyre ⁊ le man	re laissant le boyre et le man¬
gelistes monstrent/ princi¬	gelistes monstrent/ princi¬
palement sainct Mat.4.9.	palement sainct Mat.4.9.
quil estoit enuoye pour pre¬	qu’il estoit envoye pour pre¬
commande si estroictement	commande si estroictement
a ses Apostres que de pre¬	a ses Apostres que de pre¬
pasture des ames/ de laq̃lle	pasture des ames/ de laquelle
que autant quil layme/ quil	que autant qu’il l’ayme/ qu’il
donne pasture aux brebis.	donne pasture aux brebis.
¶ Et na point de desdaing le bon Iesus de prescher ⁊ ne repute point les paoures bre¬	¶ Et n’a point de desdaing le bon Jesus de prescher et ne repute point les paovres bre¬
freres/ disant: ie annonceray ton nom a mes freres. Hebre.2. ¶ O canaille qui ne te¬	freres/ disant: je annonceray ton nom a mes freres. Hebre.2. ¶ O canaille qui ne te¬
nez compte du peuple: mais que de uoz chiens ⁊ oyseaulx/ estes uous plus grand que Ie	nez compte du peuple: mais que de voz chiens et oyseaulx/ estes vous plus grand que Je¬
celuy qui dit/ Ie suis le bon pasteur/ le bon pasteur donne sa uie pour ses brebis. Ioã.10.	celuy qui dit/ Je suis le bon pasteur/ le bon pasteur donne sa vie pour ses brebis. Joan.10.
gelizer aux aultres citez le Royaulme de Dieu/ car pource suis ie enuoye: ⁊ estoit p̃schãt	gelizer aux aultres citez le Royaulme de Dieu/ car pour ce suis je envoye: et estoit preschant
aux synagogues de Galilee. Luc.4. ¶ Qui ne exerce loffice quil a prins/ nest point	aux synagogues de Galilee. Luc.4. ¶ Qui ne exerce l’office qu’il a prins/ n’est point
naduiengne que uoz coeurs soyent greuez de gourmandise ⁊ de yurongnerie/ ⁊ des soul¬	n’adviengne que voz coeurs soyent grevez de gourmandise et de yvrongnerie/ et des soul¬
dra sur tous ceulx qui sont seandz sur la face de toute la terre. Ueillez doncques prians	dra sur tous ceulx qui sont seandz sur la face de toute la terre. Veillez doncques prians
en tout temps. Luce.21.	en tout temps. Luce.21.
Luxum hic sectatur inertem.	Luxum hic sectatur inertem.
pour desrober ⁊ tuer et de¬	pour desrober et tuer et de¬
struire. Ioan.10.	struire. Joan.10.
lequel selon les droictz est	lequel selon les droictz est
de la Chrestiente/ excom¬	de la Chrestiente/ excom¬
munie auec tous ses fau¬	munie avec tous ses fau¬
cquerie/ ⁊ par argẽt il a este	cquerie/ et par argent il a este
mine domini. Lequel auec	mine domini. Lequel avec
ses predecesseurs na desire	ses predecesseurs n’a desire
tãt toutes guerres/ qui ont	tant toutes guerres/ qui ont
te gourmandise ⁊ horrible	te gourmandise et horrible
paillardise: mais quant au	paillardise: mais quant au
quest le propre office de S.	qu’est le propre office de Sainct
mettant aux aultres. c. Inter cetera. De offic. iudi. ordi. Auquel chapitre il confesse que	mettant aux aultres. c. Inter cetera. De offic. judi. ordi. Auquel chapitre il confesse que
la parolle de Dieu est la nourriture/ ⁊ uie de lame/ ⁊ en grosse diligence doibt estre annon	la parolle de Dieu est la nourriture/ et vie de l’ame/ et en grosse diligence doibt estre annon¬
toutesfoys le prestre est debteur de librement prescher la uerite laquelle il a ouye de Dieu	toutesfoys le prestre est debteur de librement prescher la verite laquelle il a ouye de Dieu
Et ilz seruent a leur uentre/ non pas a Dieu. Rom̃.16. Et pourtãt tous Euesques ne	Et ilz servent a leur ventre/ non pas a Dieu. Rom̃.16. Et pourtant tous Evesques ne
sont pas Euesques/ regarde a Pierre ⁊ considere Iudas. Rubrica. dignitas non facit	sont pas Evesques/ regarde a Pierre et considere Judas. Rubrica. dignitas non facit
¶ Malediction a ceulx qui sont apres yurongner/ se leuant du matin pour boyre iusques	¶ Malediction a ceulx qui sont apres yvrongner/ se levant du matin pour boyre jusques
ne pensez loeuure du Seigneur. Esaye.5. ¶ Ceulx icy pour le uin ont perdu lenten¬	ne pensez l’oeuvre du Seigneur. Esaye.5. ¶ Ceulx icy pour le vin ont perdu l’enten¬
demẽt/ ⁊ pour lyurongnerie faillent/ ⁊ sacrificateurs ⁊ prophetes sont errans par yuron¬	dement/ et pour l’yvrongnerie faillent/ et sacrificateurs et prophetes sont errans par yvron¬
¶ Il est deffendu de donner les biens aux ioueurs. distinc.86. donare. de iouer aux detz/	¶ Il est deffendu de donner les biens aux joueurs. distinc.86. donare. de jouer aux detz/
teur/ pariure/ ou larron doibt estre depose. distinc.81. prebyster. Si quis Episcopus. Per¬	teur/ parjure/ ou larron doibt estre depose. distinc.81. prebyster. Si quis Episcopus. Per¬
sonne ne doibt ouyr loffice dung qui tient concubine. distinctio.32. Nullus. ⁊ ce soubz pei	sonne ne doibt ouyr l’office d’ung qui tient concubine. distinctio.32. Nullus. et ce soubz pei¬
peult estre repare ne restitue a son office.	peult estre repare ne restitue a son office.
Pace/ ⁊ inops Christus.	Pace/ et inops Christus.
¶ Lange dit/ ne craignez point/ car uoi¬	¶ L’ange dit/ ne craignez point/ car voi¬
sera a tout le peuple/ car auiourdhuy uoꝰ	sera a tout le peuple/ car aujourd’huy vous
de Dauid: ⁊ ce uoꝰ sera signe/ uous trou¬	de David: et ce vous sera signe/ vous trou¬
uerez lenfant enueloppe en petis draps ⁊	verez l’enfant enveloppe en petis draps et
Lange fut une multitude de la gẽsdarme	L’ange fut une multitude de la gensdarme¬
re soit a Dieu/ ⁊ en terre paix/ ⁊ aux hom	re soit a Dieu/ et en terre paix/ et aux hom¬
mes bonne uolunte. Luce.2.	mes bonne volunte. Luce.2.
donne/ lempire sera sur ses espaules/ ⁊ ap	donne/ l’empire sera sur ses espaules/ et ap¬
Dieu fort/ Pere eternel prince de paix/	Dieu fort/ Pere eternel prince de paix/
sõ empire multipliera ⁊ sa paix sera sans	son empire multipliera et sa paix sera sans
ment. Esa.9. ¶ Quand laccomplissement du temps fust uenu/ Dieu enuoya son filz	ment. Esa.9. ¶ Quand l’accomplissement du temps fust venu/ Dieu envoya son filz
celle fin que receussiõs ladoption des filz. Gala.4. ¶ Il na point en aucun lieu prins	celle fin que receussions l’adoption des filz. Gala.4. ¶ Il n’a point en aucun lieu prins
les Anges/ mais a prins la semence de Abraham. Parquoy il a fallu quil ayt este sem¬	les Anges/ mais a prins la semence de Abraham. Parquoy il a fallu qu’il ayt este sem¬
enuers Dieu/ affin quil purifiast les pechez du peuple. Car en ce en quoy il a souffert ⁊ a	envers Dieu/ affin qu’il purifiast les pechez du peuple. Car en ce en quoy il a souffert et a
cresche/ a cause quil ny auoit point de lieu pour eulx en lhostellerie. Luce.2. ¶ Les re¬	cresche/ a cause qu’il n’y avoit point de lieu pour eulx en l’hostellerie. Luce.2. ¶ Les re¬
gnardz ont des fosses/ ⁊ les oyseaulx du ciel des nidz: mais le filz de lhomme na point	gnardz ont des fosses/ et les oyseaulx du ciel des nidz: mais le filz de l’homme n’a point
riche: affin que par sa paourete/ uous fussiez enrichis. 2.Corin.8.	riche: affin que par sa paovrete/ vous fussiez enrichis. 2.Corin.8.
⁊ le Seigneurs des Seigneurs est ne: ouurez pour Dieu les yeulx de uoz esperitz ⁊ con¬	et le Seigneurs des Seigneurs est ne: ouvrez pour Dieu les yeulx de voz esperitz et con¬
templez ce que Leuangeliste dit en peu de parolles: car comme serf ⁊ subiect aux princes	templez ce que L’evangeliste dit en peu de parolles: car comme serf et subject aux princes
ou est son palays/ ou sont ses escuyers? ou sont les beaulx draps de ueloux/ de sayes/ dor/	ou est son palays/ ou sont ses escuyers? ou sont les beaulx draps de veloux/ de sayes/ d’or/
sus Christ sont tous nudz. Il est ne au tẽps de paix/ ⁊ a sa natiuite la paix a este annon¬	sus Christ sont tous nudz. Il est ne au temps de paix/ et a sa nativite la paix a este annon¬
cee. Mais tout est trouble par le Pape ⁊ ses satellites.	cee. Mais tout est trouble par le Pape et ses satellites.
Strepitu uenit ille	Strepitu venit ille
¶ Malheur a la terre ⁊ a	¶ Malheur a la terre et a
la mer/ car le diable est de¬	la mer/ car le diable est de¬
de ire/ sachant quil a peu de	de ire/ sachant qu’il a peu de
il est courrouce il frappe le	il est courrouce il frappe le
peuple de playe incurable	peuple de playe incurable
gẽs/ persecutãt cruellemẽt.	gens/ persecutant cruellement.
uante toute la terre? qui a	vante toute la terre? qui a
du tout esmeu les Royaul¬	du tout esmeu les Royaul¬
desert? il a destruict les uil¬	desert? il a destruict les vil¬
captifz. Tu as destruict tõ	captifz. Tu as destruict ton
pays/ tu as tue ton peuple.	pays/ tu as tue ton peuple.
¶ Ne pensez que ceste guer¬	¶ Ne pensez que ceste guer¬
siõ de sang par Iulle/ Leõ/	sion de sang par Julle/ Leon/
⁊ Clement qui a aussi trahy son pays/ ⁊ sa uille de Florence ⁊ de ses semblables/ certai¬	et Clement qui a aussi trahy son pays/ et sa ville de Florence et de ses semblables/ certai¬
du glaiue/ esquelz cõpete tout ce qui est dit des faulx prophetes et seducteurs qui sont ap¬	du glaive/ esquelz compete tout ce qui est dit des faulx prophetes et seducteurs qui sont ap¬
dit/ si tu conseille a ton frere mauuaises choses/ tu le tue. de penitẽ. distin.1. Noli putare.	dit/ si tu conseille a ton frere mauvaises choses/ tu le tue. de peniten. distin.1. Noli putare.
¶ Oyons comme le Pape incite les gens a la guerre. Nous absoluons tous spirituelz	¶ Oyons comme le Pape incite les gens a la guerre. Nous absolvons tous spirituelz
glaiue spirituel doibuent user/ mais aussi du temporel/ iusques a ce quilz ayent receu toꝰ	glaive spirituel doibvent user/ mais aussi du temporel/ jusques a ce qu’ilz ayent receu tous
ceulx qui mourront en ceste bataille. 23.q.5. c. Omnium. ⁊. 23.q.8. Omni. Ainsi le Pape	ceulx qui mourront en ceste bataille. 23.q.5. c. Omnium. et. 23.q.8. Omni. Ainsi le Pape
conferme les coeurs pour hardiment se uenger ⁊ espandre le sang humain/ cõtre le com¬	conferme les coeurs pour hardiment se venger et espandre le sang humain/ contre le com¬
du a tout Euesque quil ne plaidoye point poͬ chose transitoire/ mesmes quand il seroit ti	du a tout Evesque qu’il ne plaidoye point pour chose transitoire/ mesmes quand il seroit ti¬
sonne ne prenne armes/ ⁊ nul clerc ne doibt auoir armes ne les porter. 23.q.8. Cum a Iu	sonne ne prenne armes/ et nul clerc ne doibt avoir armes ne les porter. 23.q.8. Cum a Ju¬
deis. Non pila. Clerici qui reprehensibile. ¶ Considerez les horribles guerres ⁊ ma¬	deis. Non pila. Clerici qui reprehensibile. ¶ Considerez les horribles guerres et ma¬
lequel par troys foys requis de donner la coronne de Lẽpire a Albert/ dit quil nen feroit	lequel par troys foys requis de donner la coronne de L’empire a Albert/ dit qu’il n’en feroit
me/ ⁊ de tout le monde.	me/ et de tout le monde.
Sur lasne uient Iesus doulx ⁊ bening.	Sur l’asne vient Jesus doulx et bening.
¶ Leuez uoz yeulx a la	¶ Levez voz yeulx a la
sus/ lequel faict son entree	sus/ lequel faict son entree
en la cite rebelle qui a resi¬	en la cite rebelle qui a resi¬
quelle Iesus a uoulu assem	quelle Jesus a voulu assem¬
geline assemble ses petis: ⁊	geline assemble ses petis: et
ne la point uoulu. Mat¬	ne l’a point voulu. Mat¬
uoyant la cite a pleure sur	voyant la cite a pleure sur
¶ De si grande doulceur ⁊	¶ De si grande doulceur et
misericorde est le bon Sau¬	misericorde est le bon Sau¬
sant de bien faire uoyre a	sant de bien faire voyre a
cle/ Samaritain/ faisant les uertus en la puissance de Beelzebub. Ioan.8. Matth.12.	cle/ Samaritain/ faisant les vertus en la puissance de Beelzebub. Joan.8. Matth.12.
¶ En ceste entree du tresgrand Roy ny est la grosse cheualerie/ en laquelle sont plusieurs	¶ En ceste entree du tres grand Roy n’y est la grosse chevalerie/ en laquelle sont plusieurs
Les gensdarmes armez ⁊ braues triumphans auec tous instrumens de musicque/ trom¬	Les gensdarmes armez et braves triumphans avec tous instrumens de musicque/ trom¬
les paoures gens/ ⁊ petis/ touchez du S. Esperit/ chantent/ louans Dieu/ iectãs leurs	les paovres gens/ et petis/ touchez du Sainct Esperit/ chantent/ louans Dieu/ jectans leurs
robbes a terre/ ⁊ rompans rameaulx de palme/ ⁊ de oliue/ les iectãs a terre/ les gros prin¬	robbes a terre/ et rompans rameaulx de palme/ et de olive/ les jectans a terre/ les gros prin¬
toute la uille ne uiennent au deuant/ mais sont marrys de lhõneur quon faict a Iesus/	toute la ville ne viennent au devant/ mais sont marrys de l’honneur qu’on faict a Jesus/
si tout le contraire nest trouue aux Papes/ pensez ce que disent les parolles de Dieu.	si tout le contraire n’est trouve aux Papes/ pensez ce que disent les parolles de Dieu.
Uoicy ton Roy uient a toy debonnaire/ se seant sur lasnesse et lasnon. Matthe.21.	Voicy ton Roy vient a toy debonnaire/ se seant sur l’asnesse et l’asnon. Matthe.21.
pas pour estre seruy mais pour seruir: Matthe.20. Non pas pour perdre les ames/	pas pour estre servy mais pour servir: Matthe.20. Non pas pour perdre les ames/
monde. Ioan.12.	monde. Joan.12.
Le pape aux champs sur gros roncin.	Le pape aux champs sur gros roncin.
¶ Qui pourroit dire les põ	¶ Qui pourroit dire les pom¬
festins que lon faict au Pa¬	festins que l’on faict au Pa¬
pe/ quãd il est corõne/ quãd	pe/ quand il est coronne/ quand
uille/ que de cheuaulx/ que	ville/ que de chevaulx/ que
Cardinaulx/ Euesques/	Cardinaulx/ Evesques/
Archeuesques/ Abbez/ pro¬	Archevesques/ Abbez/ pro¬
tisans/ ung chascun tache	tisans/ ung chascun tache
pour estre ueu/ ⁊ pour faire	pour estre veu/ et pour faire
honneur a ce dieu de terre/	honneur a ce dieu de terre/
contraire a Iesus qui a este	contraire a Jesus qui a este
plus paoure est orgueilleu¬	plus paovre est orgueilleu¬
sement acoustre sur toꝰ prin	sement acoustre sur tous prin¬
gneurs: ⁊ en plꝰ grosse bou¬	gneurs: et en plus grosse bou¬
fors que pour tout perdre ⁊ gaster/ ueu quil est le filz de perdition/ par lequel tout bien iusti	fors que pour tout perdre et gaster/ veu qu’il est le filz de perdition/ par lequel tout bien justi¬
ce ⁊ uertu est chasse de la terre/ ne demandant que perdre/ piller/ ⁊ destruire/ neantmoins	ce et vertu est chasse de la terre/ ne demandant que perdre/ piller/ et destruire/ neantmoins
heureux tressainct/ combien quil soit le plus mauldict ⁊ malheureux qui soit sur terre/ toꝰ	heureux tres sainct/ combien qu’il soit le plus mauldict et malheureux qui soit sur terre/ tous
tant que Iesus est loing destre demoniacle: ⁊ faisant uertus par Beelzebub/ autant est	tant que Jesus est loing d’estre demoniacle: et faisant vertus par Beelzebub/ autant est
loing le Pape du bien quon dit estre en luy. Et sil y a quelque uille qui ne le receoiue/	loing le Pape du bien qu’on dit estre en luy. Et s’il y a quelque ville qui ne le receoive/
du Pape par sang/ ⁊ par feu est faicte sur la uille/ alors nest questiõ de plourer: mais gros	du Pape par sang/ et par feu est faicte sur la ville/ alors n’est question de plourer: mais gros
tous roys/ comme signifie la teste pelee en iceulx/ ilz ont ceste tõsure de lordonnance Rõ¬	tous roys/ comme signifie la teste pelee en iceulx/ ilz ont ceste tonsure de l’ordonnance Rom¬
maine. 12.q.1. Duo. ¶ Il nous est donne de cheuaucher cõme Lempereur/ lequel est no¬	maine. 12.q.1. Duo. ¶ Il nous est donne de chevaucher comme L’empereur/ lequel est no¬
aller comme les nobles de la court de Lempereur/ car toute gloire/ honneur/ ⁊ magnifi¬	aller comme les nobles de la court de L’empereur/ car toute gloire/ honneur/ et magnifi¬
nee auec toute Lempire de occident dist.96. Constantinus. ¶ Le Pape est sur toutes	nee avec toute L’empire de occident dist.96. Constantinus. ¶ Le Pape est sur toutes
gens ⁊ Royaulmes. Extrauag. Super gentes. ¶ Uoulez uous bouche plus plaine de	gens et Royaulmes. Extravag. Super gentes. ¶ Voulez vous bouche plus plaine de
toute la terre/ ⁊ appeller Lempereur son laquect. Ie croy que les princes sont si folz quilz	toute la terre/ et appeller L’empereur son laquect. Je croy que les princes sont si folz qu’ilz
Iesus toute auarice aux apostres deffend.	Jesus toute avarice aux apostres deffend.
Ille caret nummis.	Ille caret nummis.
Dieu des le commencemẽt	Dieu des le commencement
bition ⁊ auarice/ cõme mon¬	bition et avarice/ comme mon¬
stre bien Moyse quand las¬	stre bien Moyse quand l’as¬
Abirom/ ⁊ On ausquelz les	Abirom/ et On ausquelz les
cõtre Iesus: comme iceulx	contre Jesus: comme iceulx
se leuerent contre Moyse/	se leverent contre Moyse/
lasne daucun de eulx/ ⁊ ne	l’asne d’aucun de eulx/ et ne
eulx. Num.16. ¶ Aĩsi parle	eulx. Num.16. ¶ Ainsi parle
le bon Samuel/ disant: par¬	le bon Samuel/ disant: par¬
si iay prins le beuf daucun/	si j’ay prins le beuf d’aucun/
tort ne uiolence/ ne prĩs dõ	tort ne violence/ ne prins don
de main de aucũ. 1.Reg.12.	de main de aucun. 1.Reg.12.
cun des prophetes a eu iamais aucune seigneurie. Le grand Sauueur a il faict son logis	cun des prophetes a eu jamais aucune seigneurie. Le grand Sauveur a il faict son logis
uenant en Hierusalem failloit quil retourna manger en Bethanie: disant/ quil ne auoit	venant en Hierusalem failloit qu’il retourna manger en Bethanie: disant/ qu’il ne avoit
point le droict ⁊ seigneurie sur le Royaulme de Iuda/ ⁊ sur les uilles: mais fuyant quãd	point le droict et seigneurie sur le Royaulme de Juda/ et sur les villes: mais fuyant quand
qui ont des nidz/ ⁊ que les regnardz qui ont des fosses: mais il nauoit point pour reposer	qui ont des nidz/ et que les regnardz qui ont des fosses: mais il n’avoit point pour reposer
de ses mains il a ministre a luy ⁊ a ceulx qui estoyent auec luy. Act.20. ¶ Ainsi nostre	de ses mains il a ministre a luy et a ceulx qui estoyent avec luy. Act.20. ¶ Ainsi nostre
Seigñr Iesus appelle les Apostres de la pesche/ poͬ estre pescheurs des hõmes. Mat.4.	Seigneur Jesus appelle les Apostres de la pesche/ pour estre pescheurs des hommes. Mat.4.
point uoz choses/ ne uoz biens: mais ie uous demãde. 2.Cor.12. ¶ Grãdement est deffen	point voz choses/ ne voz biens: mais je vous demande. 2.Cor.12. ¶ Grandement est deffen¬
uons apporte en ce monde/ ⁊ rien nemporterons/ nous doibt souffir dauoir nostre nourri	vons apporte en ce monde/ et rien n’emporterons/ nous doibt souffir d’avoir nostre nourri¬
ture/ ⁊ uestemens: car la racine de tous maulx est auarice. 1.Timot.6. ¶ Et ainsi Iesus	ture/ et vestemens: car la racine de tous maulx est avarice. 1.Timot.6. ¶ Et ainsi Jesus
pour la uoye/ ne deux robbes/ ne souliers/ ne uerge. Mat.10. ¶ Pierre dit. Ie nay ne or	pour la voye/ ne deux robbes/ ne souliers/ ne verge. Mat.10. ¶ Pierre dit. Je n’ay ne or
⁊ chemine. Act.3. ¶ Ou est donc maintenant le patrimoine de S. Pierre? ueu encore que	et chemine. Act.3. ¶ Ou est donc maintenant le patrimoine de Sainct Pierre? veu encore que
les canons mesmes deffendent aux ecclesiastiques de ne auoir rien ⁊ de posseder quelque	les canons mesmes deffendent aux ecclesiastiques de ne avoir rien et de posseder quelque
donation quon dit auoir este faicte par Cõstantin a Leglise Romaine.	donation qu’on dit avoir este faicte par Constantin a L’eglise Romaine.
Regna hic tenet omnia	Regna hic tenet omnia
mundi.	mundi.
que nostre Seigneur a	que nostre Seigneur a
le dos ⁊ ie me cacheray	le dos et je me cacheray
de uous/ uous mauez de¬	de vous/ vous m’avez de¬
serez subiectz a ceulx qui	serez subjectz a ceulx qui
mauldit ⁊ miserable mõ	mauldit et miserable mon¬
de aymãt uanite/ ⁊ hais¬	de aymant vanite/ et hais¬
luy qui est uenu au nom	luy qui est venu au nom
Pape qui est uenu a son	Pape qui est venu a son
nom/ ne demãdant que	nom/ ne demandant que
iceluy a baille toute sei¬	iceluy a baille toute sei¬
torite. Les princes ne	torite. Les princes ne
sont ilz point pour gar¬	sont ilz point pour gar¬
bons/ ⁊ punir les mauuais? Or quelle deffence peuuent faire ces effeminez ton¬	bons/ et punir les mauvais? Or quelle deffence peuvent faire ces effeminez ton¬
leurs pays que les papistes/ personne ne fut iamais ainsi persecutant les bons/ ⁊ def¬	leurs pays que les papistes/ personne ne fut jamais ainsi persecutant les bons/ et def¬
fedant les meschans que les papistes/ car pour faire leur uolunte il fault quilz ayent	fedant les meschans que les papistes/ car pour faire leur volunte il fault qu’ilz ayent
pre portes/ entrer aux maisons/ faire leur plaisir/ ⁊ fault que les miserables Princes	pre portes/ entrer aux maisons/ faire leur plaisir/ et fault que les miserables Princes
disent temporelz seigneurs ⁊ spirituelz/ ⁊ en grandement blasphemant Dieu/ disent	disent temporelz seigneurs et spirituelz/ et en grandement blasphemant Dieu/ disent
quilz tiennent la place de Iesus ⁊ de ses Apostres/ qui iamais ne eurẽt uille ne uillet¬	qu’ilz tiennent la place de Jesus et de ses Apostres/ qui jamais ne eurent ville ne villet¬
⁊ Roys leur seigneurie ⁊ royaulme: regardez que le Pape a ordonne. ¶ Les Eues¬	et Roys leur seigneurie et royaulme: regardez que le Pape a ordonne. ¶ Les Eves¬
affin que le nom de Euesque ne soit point uile: mais tant seulement es grandes ci¬	affin que le nom de Evesque ne soit point uile: mais tant seulement es grandes ci¬
tez/ ⁊ sur grosse multitude de peuple. distin.80. c. Urbes. c. In illis. c. Episcopi. c. Il¬	tez/ et sur grosse multitude de peuple. distin.80. c. Urbes. c. In illis. c. Episcopi. c. Il¬
ceptions des ordres qui est faicte sans tiltre/ duquel on ne peult souffisamment uiure	ceptions des ordres qui est faicte sans tiltre/ duquel on ne peult souffisamment vivre
tiltre a eu Iesus souuerain Prestre/ ⁊ ses Apostres urays Euesques/ il fault regarder	tiltre a eu Jesus souverain Prestre/ et ses Apostres vrays Evesques/ il fault regarder
les conditions que sont. 1.Timo.3. ⁊ ad Titum.1. Et ainsi le peuple les doibt esli¬	les conditions que sont. 1.Timo.3. et ad Titum.1. Et ainsi le peuple les doibt esli¬
sent ramonneurs de cheminees/ que destre ainsi meschamment uiuans et tenans	sent ramonneurs de cheminees/ que d’estre ainsi meschamment vivans et tenans
Iesus aux choses externes point ne se arreste.	Jesus aux choses externes point ne se arreste.
Quas leges dedit is.	Quas leges dedit is.
circõcision nest riẽ: mais	circoncision n’est rien: mais
demẽs de Dieu: mais la	demens de Dieu: mais la
foy ouurãte par charite:	foy ouvrante par charite:
1.Corĩ.7. Gal.5. ⁊. 6.	1.Corĩ.7. Gal.5. et. 6.
on uoꝰ presente. Lu.10.	on vous presente. Lu.10.
¶ Nul ne uous iuge en	¶ Nul ne vous juge en
en ꝑtie du ioͬ de la feste/	en partie du jour de la feste/
ou des sabbatz: qui sont	ou des sabbatz: qui sont
lombre des choses qui e¬	l’ombre des choses qui e¬
de christ. Col.2. ¶ Mã¬	de christ. Col.2. ¶ Man¬
deuãt uous. 1.Corin.10.	devant vous. 1.Corin.10.
¶ Toute creature de	¶ Toute creature de
on riẽ reiecter quon prẽt	on rien rejecter qu’on prent
mo.4. ¶ Cela qͥ entre par la bouche nest point ce q̃ souille lhõme/ mais ce qͥ sort de	mo.4. ¶ Cela qui entre par la bouche n’est point ce que souille l’homme/ mais ce qui sort de
la bouche. Matt.15. ¶ Le royaulme de Dieu ne uiẽdra point en obseruatiõ/ ⁊ ne dirõt	la bouche. Matt.15. ¶ Le royaulme de Dieu ne viendra point en observation/ et ne diront
¶ La religiõ pure ⁊ immaculee enuers Dieu ⁊ le Pere/ cest uisiter les orphelins/ ⁊ les	¶ La religion pure et immaculee envers Dieu et le Pere/ c’est visiter les orphelins/ et les
de tout son coeur: ⁊ son ꝓchain cõme soymesme. Mat.22. Laq̃lle chose est plus grãde q̃	de tout son coeur: et son prochain comme soymesme. Mat.22. Laquelle chose est plus grande que
toute offrãde ⁊ sacrifice. Mar.13. Car la plenitude de la loy est dilection. Ro.13. ¶ Le	toute offrande et sacrifice. Mar.13. Car la plenitude de la loy est dilection. Ro.13. ¶ Le
Esprit. Ro.14. ¶ Silz ne gardẽt cõtinence qͥlz se mariẽt. 1.Corĩ.7. ¶ Ilz me seruẽt en	Esprit. Ro.14. ¶ S’ilz ne gardent continence qu’ilz se marient. 1.Corĩ.7. ¶ Ilz me servent en
dẽt le mariage ⁊ de user des uiãdes. 1.Tim̃.4. ¶ ll dit des uefues si aucune na le soĩg	dent le mariage et de user des viandes. 1.Tim̃.4. ¶ ll dit des vefves si aucune n’a le soing
des siens/ ⁊ principalemẽt des domesticq̃s elle a renõce la foy/ ⁊ est pire q̃ une infidele/	des siens/ et principalement des domesticques elle a renonce la foy/ et est pire que une infidele/
affin q̃ Leglise nẽ soit chargee/ ⁊ q̃ les urayes uefues puissẽt estre entretenues. 1.Ti.5.	affin que L’eglise n’en soit chargee/ et que les vrayes vefves puissent estre entretenues. 1.Ti.5.
mesme chose: ⁊ qͥl ny ayt poĩt de sectes entre uoꝰ: ⁊ quõ ne die poĩt/ Ie suis de Paul/ ⁊	mesme chose: et qu’il n’y ayt point de sectes entre vous: et qu’on ne die point/ Je suis de Paul/ et
moy de Apollo/ ⁊ moy de Pierre/ ⁊ moy de Christ. Christ est il diuise? Paul a il este	moy de Apollo/ et moy de Pierre/ et moy de Christ. Christ est il divise? Paul a il este
q̃ nr̃e Seigñr ueult q̃ noꝰ ayõs toꝰ une mesme rigle/ foy/ loy/ ⁊ baptesme. Deuãt q̃ Ie¬	que notre Seigneur veult que nous ayons tous une mesme rigle/ foy/ loy/ et baptesme. Devant que Je¬
ctrine. Les philosophes en auoyẽt encore plus: mais le Pape a surmõte toꝰ ceulx qͥ fu	ctrine. Les philosophes en avoyent encore plus: mais le Pape a surmonte tous ceulx qui fu¬
rẽt iamais: tellemẽt q̃ lon ne scauroit nõmer les rigles ⁊ religiõs esq̃lles satã plaine¬	rent jamais: tellement que l’on ne scauroit nommer les rigles et religions esquelles satan plaine¬
Le pape dicelles tant seulement nous faict feste.	Le pape d’icelles tant seulement nous faict feste.
¶ Le pape ꝯtre la saĩcte pa¬	¶ Le pape contre la saincte pa¬
rolle de dieu/ laq̃lle ne ꝑmet	rolle de dieu/ laquelle ne promet
nãce q̃ la sienne/ ne uoulant	nance que la sienne/ ne voulant
oste rien: mais quon face ce	oste rien: mais qu’on face ce
qͥl cõmãde seulemẽt. Deut.	qu’il commande seulement. Deut.
decretz/ il a ordõne toute su¬	decretz/ il a ordonne toute su¬
enfans nayẽt a laisser pere ⁊	enfans n’ayent a laisser pere et
mere soubz lombre de reli¬	mere soubz l’ombre de reli¬
ligiõ naye a coupper ses che	ligion n’aye a coupper ses che¬
quõ ne mesprise le mariage/	qu’on ne mesprise le mariage/
ne celuy qͥ mãge de la chair/	ne celuy qui mange de la chair/
fans pour religion/ q̃ nul ne	fans pour religion/ que nul ne
distin.30. Si qͥs uirorum.	distin.30. Si quis virorum.
¶ Nul chartreux/ nul cele¬	¶ Nul chartreux/ nul cele¬
colette/ nul des enfumez mi	colette/ nul des enfumez mi¬
Nulle ꝑsonne ne ose manger chair/ oeufz/ fromage/ ne chose de laict/ despuis la qͥnquage	Nulle personne ne ose manger chair/ oeufz/ fromage/ ne chose de laict/ despuis la quinquage¬
sime iusq̃s a Pasques. distĩ.4.  Deniqꝫ. Noꝰ uoulõs aussi quõ ieune le mercredy/ le uen¬	sime jusques a Pasques. distin.4.  Denique. Nous voulons aussi qu’on jeune le mercredy/ le ven¬
les ueilles des apostres auec les aduẽtz. de obserua. ieiu. Conciliũ. Noꝰ dõnõs planiere	les veilles des apostres avec les adventz. de observa. jeju. Concilium. Nous donnons planiere
dict iubile. Sixtus.4. Quẽadmodũ. La religion du pape est que chartreux/ ou celestin/	dict jubile. Sixtus.4. Quemadmodum. La religion du pape est que chartreux/ ou celestin/
ne seur colette iamais ne sorte/ ne moyne ne nõnain sans le cõgie de son superieur/ quilz	ne seur colette jamais ne sorte/ ne moyne ne nonnain sans le congie de son superieur/ qu’ilz
desobeissant a pere ⁊ mere/ cõtreuenãt a tout debuoir poͬ garder leurs rigles. Ceulx qui	desobeissant a pere et mere/ contrevenant a tout debvoir pour garder leurs rigles. Ceulx qui
teris. Le filz ou la fille q̃ ses parẽs en son enfance ont mis au monastere ne peuuẽt sortir	teris. Le filz ou la fille que ses parens en son enfance ont mis au monastere ne peuvent sortir
ne se marier. 20.q.1. Addidistis. Et si aucun ou aucune apres le ueu de chastete se ma¬	ne se marier. 20.q.1. Addidistis. Et si aucun ou aucune apres le veu de chastete se ma¬
est/ beau/ sainct Augustin dit q̃ celuy peche/ qͥ les separe/ ⁊ quõ ne les doibt point separer.	est/ beau/ sainct Augustin dit que celuy peche/ qui les separe/ et qu’on ne les doibt point separer.
Sueto. de uiris illust. ca.1. Les uierges de la deesse Uesta/ ne se pouuoient marier/ ⁊ de la	Sueto. de viris illust. ca.1. Les vierges de la deesse Vesta/ ne se pouvoient marier/ et de la
punition de celle qͥ auoit uiole sa uirginite. Lisez Titu Liuiũ. 1. ab urb. cõd. ⁊ Aul. Gel.	punition de celle qui avoit viole sa virginite. Lisez Titu Liuium. 1. ab urb. cond. et Aul. Gel.
grosse diuersite de dieux/ ⁊ selon les dieux les prestres comme on uoit en la religion du	grosse diversite de dieux/ et selon les dieux les prestres comme on voit en la religion du
tonsures/ ceremonies. Extra. Quia quorundam. de uerbo. signi. ⁊. 21.q.4. Episcopi.	tonsures/ ceremonies. Extra. Quia quorundam. de verbo. signi. et. 21.q.4. Episcopi.
Ceulx qui ont apostate de la foy prenant aultre rigle que celle de Iesus sont appellez	Ceulx qui ont apostate de la foy prenant aultre rigle que celle de Jesus sont appellez
Du temple Iesus chasse tous usuriers.	Du temple Jesus chasse tous usuriers.
¶ Il trouua au tẽple gens	¶ Il trouva au temple gens
qui uendoyent beufz ⁊ bre¬	qui vendoyent beufz et bre¬
geurs qui estoyent assis.	geurs qui estoyent assis.
me ung fouet de petites cor	me ung fouet de petites cor¬
des/ il les iecta tous hors	des/ il les jecta tous hors
beufz/ ⁊ respandit largent	beufz/ et respandit l’argent
les tables. Et dist a ceulx	les tables. Et dist a ceulx
qui uendoyent les colom¬	qui vendoyent les colom¬
ne faictes point la maison	ne faictes point la maison
marche. Ioan.2.	marche. Joan.2.
¶ Et quand il fut entre au	¶ Et quand il fut entre au
hors les uendans ⁊ ache¬	hors les vendans et ache¬
Ma maison est maison do¬	Ma maison est maison d’o¬
raison/ ⁊ uous lauez faicte une cauerne de meurtriers. Luce.19. ¶ Sil est ainsi q̃ no	raison/ et vous l’avez faicte une caverne de meurtriers. Luce.19. ¶ S’il est ainsi que no¬
ne fault point penser que Dieu aye sa demeure/ car le treshault ne demeure point es tem¬	ne fault point penser que Dieu aye sa demeure/ car le tres hault ne demeure point es tem¬
chandise en son Eglise/ qui est la congregation des Chrestiens soyent chassez/ ⁊ pourtãt	chandise en son Eglise/ qui est la congregation des Chrestiens soyent chassez/ et pourtant
en ladministration de ses dons ⁊ graces/ il deffend toute telle trafficquerie/ disant: Uous	en l’administration de ses dons et graces/ il deffend toute telle trafficquerie/ disant: Vous
en perdition/ pource que tu as estime que le don de Dieu soit donne pour argent. Act.8.	en perdition/ pour ce que tu as estime que le don de Dieu soit donne pour argent. Act.8.
dition. Il est predict de telz marchans en S. Pierre/ disant: Aussi ya eu des faulx pro¬	dition. Il est predict de telz marchans en Sainct Pierre/ disant: Aussi y a eu des faulx pro¬
phetes entre le peuple: comme il y aura entre uous des maistres mensongiers qui in¬	phetes entre le peuple: comme il y aura entre vous des maistres mensongiers qui in¬
mesme soubdaine perdition. Et plusieurs suyuront leurs fornications/ par lesquelz la	mesme soubdaine perdition. Et plusieurs suyvront leurs fornications/ par lesquelz la
ctes: ausquelz la condemnation des long temps ne cesse point: ⁊ leur perdition ne som¬	ctes: ausquelz la condemnation des long temps ne cesse point: et leur perdition ne som¬
meille point. 2.Pet.2. ¶ Le paoure monde si nestoit bien aueugle pourroit bien con¬	meille point. 2.Pet.2. ¶ Le paovre monde si n’estoit bien aveugle pourroit bien con¬
ses: affin que la soubz lombre de religion/ comme guetteurs de chemins ⁊ auenturiers	ses: affin que la soubz l’ombre de religion/ comme guetteurs de chemins et aventuriers
biens: mais en lame quant au lieu de les mener a Iesuchrist/ leur uendent leur fardee	biens: mais en l’ame quant au lieu de les mener a Jesuchrist/ leur vendent leur fardee
⁊ corrompue marchandise en toute superstition ⁊ idolatrie.	et corrompue marchandise en toute superstition et idolatrie.
Quos accipit ille.	Quos accipit ille.
Lãtechrist/ qui se sied au tẽ¬	L’antechrist/ qui se sied au tem¬
ple de Dieu (es coeurs des	ple de Dieu (es coeurs des
⁊ se mõstrãt cõme Dieu/ cõe	et se monstrant comme Dieu/ come
Car il a change toute or¬	Car il a change toute or¬
dõnance diuine/ cõe Daniel	donnance divine/ come Daniel
Escripture/ uẽdant indulgẽ¬	Escripture/ vendant indulgen¬
nãt dune partie/ maintenãt	nant d’une partie/ maintenant
de tous pechez: ⁊ aussi dispẽ¬	de tous pechez: et aussi dispen¬
rifie/ qͥl peult dispenser cõtre	rifie/ qu’il peult dispenser contre
Apostres/ comme notẽt ses	Apostres/ comme notent ses
glossateurs. 34.dist. Lector.	glossateurs. 34.dist. Lector.
De uoto ⁊ uoti redẽp. ꝑto¬	De voto et voti redemp. parto¬
teur ne soit poĩt tenu destre	teur ne soit point tenu d’estre
soubz son seigñr ainsi quil a	soubz son seigneur ainsi qu’il a
1.Pet.2. Et si change les ueufz ainsi q̃l ueult/ ⁊ ueult q̃ ce quil ordõne soit receu cõme de	1.Pet.2. Et si change les veufz ainsi quel veult/ et veult que ce qu’il ordonne soit receu comme de
sainctz les dãnez/ il mauldict iusques a la tierce ⁊ quarte generation/ faisant les choses	sainctz les damnez/ il mauldict jusques a la tierce et quarte generation/ faisant les choses
droictes ou tortues cõe il ueult/ cõmãdant q̃ personne nen parle ne en doubte. 17.q.4. Ne¬	droictes ou tortues come il veult/ commandant que personne n’en parle ne en doubte. 17.q.4. Ne¬
prẽnent q̃lque chose poͬ graces/ ordres/ ⁊ telz cas anathema danti. ⁊ recipiẽti. 1.q.1. ⁊ q̃ on	prennent quelque chose pour graces/ ordres/ et telz cas anathema danti. et recipienti. 1.q.1. et que on
ou cõmunion. 1.q.1. Dictũ est. ex ꝯcil. Tuburiẽsi. Ne encores quãd on les cõtraindroit de	ou communion. 1.q.1. Dictum est. ex concil. Tuburiensi. Ne encores quand on les contraindroit de
prẽdre: 13.q.2. postꝗ̈ pretio. Dõt il est patẽt que les simoniacles/ cõme premiers ⁊ princi¬	prendre: 13.q.2. postꝗ̈ pretio. Dont il est patent que les simoniacles/ comme premiers et princi¬
heresie de Macedoniꝰ ⁊ de ceulx qͥ a lentour de luy sont repugnãtz au S. Esprit/ est plꝰ	heresie de Macedonius et de ceulx qui a l’entour de luy sont repugnantz au Sainct Esprit/ est plus
estre creature/ ⁊ seruiteur du Pere ⁊ du Filz: mais ces symoniacles font iceluy mesme S.	estre creature/ et serviteur du Pere et du Filz: mais ces symoniacles font iceluy mesme Sainct
Esprit seruiteur. 1.q.1. c. Eos. Gregoriꝰ in registro. ¶ Puis q̃ ainsi est que auarice est serui	Esprit serviteur. 1.q.1. c. Eos. Gregorius in registro. ¶ Puis que ainsi est que avarice est servi¬
iect uulgairemẽt a la perditiõ de infidelite/ cõbien q̃ semble tenir la foy laq̃lle il mesprise.	ject vulgairement a la perdition de infidelite/ combien que semble tenir la foy laquelle il mesprise.
aymẽt tant le loyer diniquite/ q̃ les scauãs mesme sont reprins des ignares/ ⁊ les clercz	ayment tant le loyer d’iniquite/ que les scavans mesme sont reprins des ignares/ et les clercz
des laiz. Car ilz corrõpent la parolle de uerite pour lamour de la pecune/ ⁊ des desirs tẽ¬	des laiz. Car ilz corrompent la parolle de verite pour l’amour de la pecune/ et des desirs tem¬
qͥ les corrigent: mais choses pleines derreurs qui leur cõplaisent.	qui les corrigent: mais choses pleines d’erreurs qui leur complaisent.
Spernit opes Christus.	Spernit opes Christus.
¶ Il fault soustenir les foi¬	¶ Il fault soustenir les foi¬
parolles du seigneur Iesus.	parolles du seigneur Jesus.
benoiste de dõner q̃ de pren¬	benoiste de donner que de pren¬
dre. Act.20. ¶ Pourquoy	dre. Act.20. ¶ Pourquoy
de Iesus/ dautãt est on plus	de Jesus/ d’autant est on plus
me dit S. Paul. Ie nay poĩt	me dit Sainct Paul. Je n’ay point
conuoite largent ne lor/ ou	convoite l’argent ne l’or/ ou
scauez que ces mains icy	scavez que ces mains icy
tez/ ⁊ a ceulx qui sont auec	tez/ et a ceulx qui sont avec
moy. Act.20.	moy. Act.20.
piete auec le coeur content	piete avec le coeur content
uons rien apporte en ce mõ¬	vons rien apporte en ce mon¬
de: il nest a doubter q̃ riens	de: il n’est a doubter que riens
1.Timo.6. ¶ Malheur sur uous o scribes ⁊ pharisiens hypocrites qui mãgez les mai¬	1.Timo.6. ¶ Malheur sur vous o scribes et pharisiens hypocrites qui mangez les mai¬
demnatiõ. Matth.23. ¶ Faictes uoz thresors au ciel/ la ou ne la rouilleure/ ne la tigne	demnation. Matth.23. ¶ Faictes voz thresors au ciel/ la ou ne la rouilleure/ ne la tigne
ne corrompent riẽs/ ⁊ la ou les larrons ne esfouyssent/ ⁊ ne desrobent point. Matt.6.	ne corrompent riens/ et la ou les larrons ne esfouyssent/ et ne desrobent point. Matt.6.
sirs inutiles ⁊ nuysans/ lesquelz plongẽt les hõmes en mort ⁊ en perdition/ car la racine	sirs inutiles et nuysans/ lesquelz plongent les hommes en mort et en perdition/ car la racine
sont touchez tous papisticques/ qui ne pensent estre aultre piete que gaing/ enseignans	sont touchez tous papisticques/ qui ne pensent estre aultre piete que gaing/ enseignans
aultrement que S. Paul audict chapitre nenseigne: ⁊ pourtant sont appellez idolatres:	aultrement que Sainct Paul audict chapitre n’enseigne: et pourtant sont appellez idolatres:
part en la premiere resurrection. Apoca.20. ¶ Quon regarde si Iesus a monstre ne en¬	part en la premiere resurrection. Apoca.20. ¶ Qu’on regarde si Jesus a monstre ne en¬
mais tire fors que de prescher purement la parolle de Dieu sans y rien mesler. Et au cõ¬	mais tire fors que de prescher purement la parolle de Dieu sans y rien mesler. Et au con¬
traire est il possible de penser aucune maniere ⁊ fasson de tirer argent du paoure peuple?	traire est il possible de penser aucune maniere et fasson de tirer argent du paovre peuple?
pe a controuue? Il nest soulier/ corde/ chausse/ robbe/ braye/ pierre/ saincture/ bõnet/ bastõt/	pe a controuve? Il n’est soulier/ corde/ chausse/ robbe/ braye/ pierre/ saincture/ bonnet/ bastont/
gent/ ⁊ de tout tant quont ueult: des cloux de Iesus tout en est plein: des circoncisions a	gent/ et de tout tant qu’ont veult: des cloux de Jesus tout en est plein: des circoncisions a
Rõme il y en a/ ⁊ au Puis/ ⁊ en aultres lieulx: cõme si plusieurs fois Iesus auoit este cir¬	Romme il y en a/ et au Puis/ et en aultres lieulx: comme si plusieurs fois Jesus avoit este cir¬
Sur terre ne demande lautre que or.	Sur terre ne demande l’autre que or.
¶ Tout ce q̃ le Pape a	¶ Tout ce que le Pape a
peu prẽdre des Iuifz de	peu prendre des Juifz de
idolatres/ il a tout intro	idolatres/ il a tout intro¬
ler le mõde/ disant a ces	ler le monde/ disant a ces
pilleurs qͥl enuoye. Dõ¬	pilleurs qu’il envoye. Don¬
sel/ eau benistes/ cẽdres/	sel/ eau benistes/ cendres/
ches/ chãtz/ benedictiõs/	ches/ chantz/ benedictions/
grãs agios/ inclinatiõs	grans agios/ inclinations
affin q̃ uoꝰ ayez deulx/	affin que vous ayez d’eulx/
tes/ or ⁊ argent/ uendez	tes/ or et argent/ vendez
os des sainctz/ reliques/	os des sainctz/ reliques/
tout/ prenãt tout ce que	tout/ prenant tout ce que
exactiõ toute descouuer	exaction toute descouver¬
te/ neãtmoins contrai¬	te/ neantmoins contrai¬
ner ce qͥl ont de coustume/ ainsi q̃ noꝰ auõs cõmãde aux Euesq̃s. Ad aposto. de symo	ner ce qu’il ont de coustume/ ainsi que nous avons commande aux Evesques. Ad aposto. de symo¬
quõ les receoiue: car il est hõneste quõ receoiue/ ce qͥl nest pas hõneste de demander. 18.	qu’on les receoive: car il est honneste qu’on receoive/ ce qu’il n’est pas honneste de demander. 18.
dist. De eulogiis. ⁊. c. Cũ ex offi. de prescrip. 12.q.2. Charitatẽ. 13.q.2. questa. ⁊. 1.q.2.	dist. De eulogiis. et. c. Cum ex offi. de prescrip. 12.q.2. Charitatem. 13.q.2. questa. et. 1.q.2.
brebis sans laine. Soyent excõmuniez cõme infideles/ ⁊ qͥ tuẽt les indigẽs/ ceulx qui	brebis sans laine. Soyent excommuniez comme infideles/ et qui tuent les indigens/ ceulx qui
le mõde/ nayãs cure q̃ de leur uẽtre ⁊ de la bourse/ q̃ mesmes leurs flateurs qͥ ne tachẽt	le monde/ n’ayans cure que de leur ventre et de la bourse/ que mesmes leurs flateurs qui ne tachent
q̃ les mettre sur toꝰ sõt cõtrainctz les blasmer. Quon regarde la glose extrauag. de se¬	que les mettre sur tous sont contrainctz les blasmer. Qu’on regarde la glose extravag. de se¬
poͬ tousiours augmẽter le gain auec la superstitiõ/ portãs chasses ⁊ aultres reliq̃s a li¬	pour tousjours augmenter le gain avec la superstition/ portans chasses et aultres reliques a l’i¬
telle põpe portoyẽt leurs dieux/ cõe il est facile a ueoir en Apuleius lib.xi ¶ Ilz auoyẽt	telle pompe portoyent leurs dieux/ come il est facile a veoir en Apuleius lib.xi ¶ Ilz avoyent
ainsi la coustume dallumer cierges: cõe Dionys. Halicar. ⁊ Macrob. Satur. lib.i.c.ui.	ainsi la coustume d’allumer cierges: come Dionys. Halicar. et Macrob. Satur. lib.i.c.vi.
remonies tout en est plein ꝑ les liures des ĩfideles. Quid. in fastis. Apule. Macrob ⁊c.	remonies tout en est plein par les livres des infideles. Quid. in fastis. Apule. Macrob etc.
⁊ retire les coeurs du uray pasteur Iesꝰ Christ. ¶ Nul Euesq̃/ ou prestre/ ou diacre/ qͥ	et retire les coeurs du vray pasteur Jesus Christ. ¶ Nul Evesque/ ou prestre/ ou diacre/ qui
dispẽse le sacremẽt de la cõmuniõ ne demãde aucune chose. Car la grace nest pas uen¬	dispense le sacrement de la communion ne demande aucune chose. Car la grace n’est pas ven¬
tateur de la deceptiõ ⁊ fraulde symoniacque. Ex septa synodo. 1.q.1. ⁊c.	tateur de la deception et fraulde symoniacque. Ex septa synodo. 1.q.1. etc.
ein Sack	ein Sack
uol ablass	vol ablass
largent	l’argent
plein de	plein de
pardõs.	pardons.
Pascit oues Christus.	Pascit oves Christus.
brebis perdue/ il la met	brebis perdue/ il la met
sur ses espaules sesiouys¬	sur ses espaules s’esjouys¬
¶ Il uit grande multi¬	¶ Il vit grande multi¬
sur eulx/ car ilz estoyẽt	sur eulx/ car ilz estoyent
comme brebis qui nont	comme brebis qui n’ont
mẽcea leͬ enseigner plu¬	mencea leur enseigner plu¬
il eut prĩs les cinq paĩs/	il eut prins les cinq pains/
et les deux poissons/ il	et les deux poissons/ il
⁊ rendit graces ⁊ rompit	et rendit graces et rompit
ses disciples: affin quilz	ses disciples: affin qu’ilz
les missẽt deuãt iceulx/	les missent devant iceulx/
¶ Ie suis le bon pasteur allant deuant mes brebis/ lesquelles ie paistz/ mettant	¶ Je suis le bon pasteur allant devant mes brebis/ lesquelles je paistz/ mettant
naire. Io.10. ¶ Nul na plus grande dilection que ceste: quand aucun met son	naire. Jo.10. ¶ Nul n’a plus grande dilection que ceste: quand aucun met son
ame pour ses amys. Ioan.15. ¶ Il donra pasture a son troupeau comme ung	ame pour ses amys. Joan.15. ¶ Il donra pasture a son troupeau comme ung
¶ Le bon sauueur a ce inuite tous chargez ⁊ trauaillez pour uenir a luy ⁊ estre sou¬	¶ Le bon sauveur a ce invite tous chargez et travaillez pour venir a luy et estre sou¬
Ioan.7. ¶ Cecy ont suyui les urays disciples de Iesus Christ non pas Iudas	Joan.7. ¶ Cecy ont suyvi les vrays disciples de Jesus Christ non pas Judas
qui estoit larron/ duquel sont successeurs le Pape ⁊ les siens: mais S. Pierre ⁊ les	qui estoit larron/ duquel sont successeurs le Pape et les siens: mais Sainct Pierre et les
tu scais que ie tayme/ Iesus Christ dit: Paistz mes brebis: lesquelles il a nourry de	tu scais que je t’ayme/ Jesus Christ dit: Paistz mes brebis: lesquelles il a nourry de
peau de Dieu qui est entre uous: pouruoyans non point par contraincte: mais uo¬	peau de Dieu qui est entre vous: pourvoyans non point par contraincte: mais vo¬
luntairement/ non point deshonnestement appettant gaing: mais uoluntairement/	luntairement/ non point deshonnestement appettant gaing: mais voluntairement/
plaire du troupeau. Et quãd le prince des pasteurs apparoistra uoꝰ receurez la coron¬	plaire du troupeau. Et quand le prince des pasteurs apparoistra vous recevrez la coron¬
Le pape les deuore trescruellement.	Le pape les devore tres cruellement.
Inopis hic sanguine	Inopis hic sanguine
Le pape dessẽd aux	Le pape dessend aux
sent aller ca ne la en	sent aller ca ne la en
tirãt subtilemẽt lor	tirant subtilement l’or
pardons ⁊ remissiõs	pardons et remissions
pechez/ et aucunes¬	pechez/ et aucunes¬
foys de tous/ ⁊ de pei	foys de tous/ et de pei¬
Dieu seul peult fai¬	Dieu seul peult fai¬
leuant ⁊ mettãt sur	levant et mettant sur
Dieu: pourtant leur	Dieu: pourtant leur
tres ⁊ bulles ilz no¬	tres et bulles ilz n’o¬
estre admis: De pe¬	estre admis: De pe¬
niten. ⁊ remis. in cle¬	niten. et remis. in cle¬
est mauldict tout homme qui les empesche ou qui parle contre. Nous ordon¬	est mauldict tout homme qui les empesche ou qui parle contre. Nous ordon¬
de pensions/ que la peine des exactions le cõtraigne se retourner a Dieu. 23.q.7.	de pensions/ que la peine des exactions le contraigne se retourner a Dieu. 23.q.7.
Iam uero. Et pourtant noꝰ uoulons quon baille la .x. partie de toutes choses/ soit	Jam vero. Et pourtant nous voulons qu’on baille la .x. partie de toutes choses/ soit
ges/ ⁊ quelque chose que soit legitimement acquestee/ ⁊ de toute marchandise/ uoi	ges/ et quelque chose que soit legitimement acquestee/ et de toute marchandise/ voi¬
ou quelque aultre marchandise/ ⁊ aussi des mouches a miel/ ⁊ de la chasse/ ⁊ de la	ou quelque aultre marchandise/ et aussi des mouches a miel/ et de la chasse/ et de la
gensdarmerie/ cest adire des gaiges que lont prent/ ⁊ de ce que lon cõqueste ⁊ de tou	gensdarmerie/ c’est a dire des gaiges que l’ont prent/ et de ce que l’on conqueste et de tou¬
Ex trãsmissa. A nobis. Pastoralis: ⁊ in aliis capi. de deci. ⁊ primi. ⁊ obla. ¶ Icy	Ex transmissa. A nobis. Pastoralis: et in aliis capi. de deci. et primi. et obla. ¶ Icy
bis/ comme ilz mettent sur noz espaules fardeaulx importables/ lesquelz ilz ne	bis/ comme ilz mettent sur noz espaules fardeaulx importables/ lesquelz ilz ne
touchent point dung doigt. Matth.23. ⁊. 7. Dieu les mauldict comme faulx	touchent point d’ung doigt. Matth.23. et. 7. Dieu les mauldict comme faulx
¶ Affin quon congnoisse ces corbeaulx/ le Pape ⁊ les siens/ ses decretz le mani	¶ Affin qu’on congnoisse ces corbeaulx/ le Pape et les siens/ ses decretz le mani¬
lumbe. Les corbeaulx sont nourris de mort/ la columbe na point cecy/ mais uis	lumbe. Les corbeaulx sont nourris de mort/ la columbe n’a point cecy/ mais vis
des fruictz de la terre/ ⁊ sa uie est innocente. 2.questio.7. Non omnis.	des fruictz de la terre/ et sa vie est innocente. 2.questio.7. Non omnis.
E	E¬
leur dit. Iay desire de desir de manger ceste pasque/ cest adire ce passage	leur dit. J’ay desire de desir de manger ceste pasque/ c’est a dire ce passage
laigneau qui estoit memoire du passage auec uous deuant que ie souffre/	l’aigneau qui estoit memoire du passage avec vous devant que je souffre/
au royaulme de Dieu. Et il print le calice ⁊ rendit graces: ⁊ dit. Prenez ⁊ le distri¬	au royaulme de Dieu. Et il print le calice et rendit graces: et dit. Prenez et le distri¬
ques a ce que le Royaulme de Dieu uiengne. Le Seigñr Iesus en la nuict en la¬	ques a ce que le Royaulme de Dieu viengne. Le Seigneur Jesus en la nuict en la¬
quelle il fut liure/ quand ilz mãgeoyent/ print le pain/ ⁊ en rendant graces le rõ¬	quelle il fut livre/ quand ilz mangeoyent/ print le pain/ et en rendant graces le rom¬
est liure/ faictes ce en memoire de moy. Sẽblablemẽt le calice apres qͥl eut souppe/	est livre/ faictes ce en memoire de moy. Semblablement le calice apres qu’il eut souppe/
⁊ beurẽt diceluy tous/ ⁊ leur dit. Cestuy est mon sang du nouueau testament/ qui	et beurent d’iceluy tous/ et leur dit. Cestuy est mon sang du nouveau testament/ qui
pour plusieurs sera respandu en remission des pechez. Ce calice est le nouueau te¬	pour plusieurs sera respandu en remission des pechez. Ce calice est le nouveau te¬
beuurez en memoire de moy. Car toutes les foys que uous mangerez ce pain/ et	beuvrez en memoire de moy. Car toutes les foys que vous mangerez ce pain/ et
Iesus debuoit mourir pour la gent: ⁊ non seulement pour la gent: mais affin aussi	Jesus debvoit mourir pour la gent: et non seulement pour la gent: mais affin aussi
quil assemblast les filz de Dieu en ung/ qui estoyent espars. Ie ne prie point seu¬	qu’il assemblast les filz de Dieu en ung/ qui estoyent espars. Je ne prie point seu¬
que tous soyent ung/ ainsi que toy Pere es en moy/ ⁊ moy en toy/ que aussi en nous	que tous soyent ung/ ainsi que toy Pere es en moy/ et moy en toy/ que aussi en nous
siez tous une mesme chose/ ⁊ qͥl ny aye point de sectes entre uous: mais soyez par¬	siez tous une mesme chose/ et qu’il n’y aye point de sectes entre vous: mais soyez par¬
faictz en ung mesme sens/ ⁊ en une mesme sentence. Certes nous tous sommes	faictz en ung mesme sens/ et en une mesme sentence. Certes nous tous sommes
Iuif ne payen/ il ny a serf ne franc/ il ny a ne masle ne femelle: uous tous certes	Juif ne payen/ il n’y a serf ne franc/ il n’y a ne masle ne femelle: vous tous certes
Uous ne uoꝰ assemblez point ensemble en mieulx: mais en pis/ il y a des diuisiõs	Vous ne vous assemblez point ensemble en mieulx: mais en pis/ il y a des divisions
entre uous/ car ung chascun preuient a manger sa cene/ ⁊ lung a faim/ ⁊ laultre est	entre vous/ car ung chascun previent a manger sa cene/ et l’ung a faim/ et l’aultre est
glise de Dieu: quand uous uenez ensemble pour manger attendez lung laultre.	glise de Dieu: quand vous venez ensemble pour manger attendez l’ung l’aultre.
Experimentez uous uous mesmes si uous estes en la foy/ esprouuez uous uous	Experimentez vous vous mesmes si vous estes en la foy/ esprouvez vous vous
mesmes/ ne cõgnoissez uous point uous mesmes que Iesus Christ est en uous? si	mesmes/ ne congnoissez vous point vous mesmes que Jesus Christ est en vous? si
pere uous pardonnera/ ⁊ si uous ne pardonnez aux hommes leurs pechez/ uostre	pere vous pardonnera/ et si vous ne pardonnez aux hommes leurs pechez/ vostre
Iesus nous a cõmande de prier. Et nous remet noz offenses ainsi que nous remet	Jesus nous a commande de prier. Et nous remet noz offenses ainsi que nous remet¬
tons a ceulx qͥ nous ont offense. Il est ung Dieu/ ⁊ ung mediateur de Dieu ⁊ des	tons a ceulx qui nous ont offense. Il est ung Dieu/ et ung mediateur de Dieu et des
tous. Si aucun a peche nous auons ung aduocat enuers le Pere Iesus Christ le	tous. Si aucun a peche nous avons ung advocat envers le Pere Jesus Christ le
mais aussi pour ceulx de tout le monde. Il ny a point de salut en aucun aultre/ car	mais aussi pour ceulx de tout le monde. Il n’y a point de salut en aucun aultre/ car
il ny a aultre nom donne aux hommes/ auquel il nous faille estre sauuez. Ie	il n’y a aultre nom donne aux hommes/ auquel il nous faille estre sauvez. Je
Iesꝰ uenir a luy/ ⁊ dit: uoicy laigneau de Dieu/ uoicy celuy qui oste les pechez du	Jesus venir a luy/ et dit: voicy l’aigneau de Dieu/ voicy celuy qui oste les pechez du
de sa mort ⁊ passion.	de sa mort et passion.
la grace diceluy par la redemptiõ laquelle est en Iesus Christ/ lequel Dieu a mis	la grace d’iceluy par la redemption laquelle est en Jesus Christ/ lequel Dieu a mis
par nostre Seigneur Iesus Christ/ par lequel nous auons acces par foy en ceste	par nostre Seigneur Jesus Christ/ par lequel nous avons acces par foy en ceste
deliurez de lyre par luy. Nous auons este reconciliez a Dieu par la mort de son	delivrez de l’yre par luy. Nous avons este reconciliez a Dieu par la mort de son
filz/ pourquoy reconciliez/ seront sauuez en la uie diceluy. Nous nous glorifions	filz/ pourquoy reconciliez/ seront sauvez en la vie d’iceluy. Nous nous glorifions
maintenãt. Uous estes faictz pres par le sang de Christ/ car il est nostre paix/ qui	maintenant. Vous estes faictz pres par le sang de Christ/ car il est nostre paix/ qui
Pere: son bon plaisir a este quen luy toute plenitude habitast: ⁊ que par luy toutes	Pere: son bon plaisir a este qu’en luy toute plenitude habitast: et que par luy toutes
choses fusseut recõciliees enuers luy/ appaisant par le sang de sa passion les choses	choses fusseut reconciliees envers luy/ appaisant par le sang de sa passion les choses
toutes choses/ auoir amene beaucoup denfans a gloire/ quil fut faict aucteur par¬	toutes choses/ avoir amene beaucoup d’enfans a gloire/ qu’il fut faict aucteur par¬
pire de mort: cest adire/ le diable. Il a fallu quil aye este semblable par toutes cho¬	pire de mort: c’est a dire/ le diable. Il a fallu qu’il aye este semblable par toutes cho¬
ses a ses freres a ce quil fut misericordieux ⁊ souuerain Sacrificateur fidele en¬	ses a ses freres a ce qu’il fut misericordieux et souverain Sacrificateur fidele en¬
este tente il est puissant aussi de ayder a ceulx qui sont tentez. Nous auõs le grãd	este tente il est puissant aussi de ayder a ceulx qui sont tentez. Nous avons le grand
confession de nostre esperance/ car nous nauons point ung souuerain Sacrifica¬	confession de nostre esperance/ car nous n’avons point ung souverain Sacrifica¬
teur/ qui ne puisse auoir compassion de noz infirmitez: mais tente en toutes cho¬	teur/ qui ne puisse avoir compassion de noz infirmitez: mais tente en toutes cho¬
que nous obtenons misericorde/ ⁊ trouuons grace en ayde cõuenable. Christ ne	que nous obtenons misericorde/ et trouvons grace en ayde convenable. Christ ne
celuy qui a parle a luy. Tu es mon filz/ auiourdhuy ie tay engendre/ cõme aussi	celuy qui a parle a luy. Tu es mon filz/ aujourd’huy je t’ay engendre/ comme aussi
en aultre lieu il dit. Tu es Sacrificateur eternellement selon lordre de Melchi¬	en aultre lieu il dit. Tu es Sacrificateur eternellement selon l’ordre de Melchi¬
uoit sauuer de mort auec grand cry ⁊ larmes/ ⁊ fut exaulce pour sa reuerence. Et	voit sauver de mort avec grand cry et larmes/ et fut exaulce pour sa reverence. Et
ses quil souffrit/ ⁊ luy qͥ estoit tout parfaict a este faict cause de salut eternel a toꝰ	ses qu’il souffrit/ et luy qui estoit tout parfaict a este faict cause de salut eternel a tous
ceulx qui luy obeissent/ appelle de Dieu souuerain Sacrificateur selon lordre de	ceulx qui luy obeissent/ appelle de Dieu souverain Sacrificateur selon l’ordre de
mort estoyent empeschez de demourer: mais cestuy pour ce quil demeure eternelle¬	mort estoyent empeschez de demourer: mais cestuy pour ce qu’il demeure eternelle¬
ment ceulx qui sapprochent de Dieu par luy/ uiuant tousiours pour interceder	ment ceulx qui s’approchent de Dieu par luy/ vivant tousjours pour interceder
pour nous/ car il estoit conuenable que nous eussions ung tel souuerain Sacrifi¬	pour nous/ car il estoit convenable que nous eussions ung tel souverain Sacrifi¬
cieulx/ lequel na point necessite comme les souuerains Sacrificateurs offrir tous	cieulx/ lequel n’a point necessite comme les souverains Sacrificateurs offrir tous
du peuple/ car il a faict en soy offrant une foys. Certes la loy ordonne les hom¬	du peuple/ car il a faict en soy offrant une foys. Certes la loy ordonne les hom¬
mes souuerains Sacrificateurs qui ont infirmite: mais la parolle du iurement/	mes souverains Sacrificateurs qui ont infirmite: mais la parolle du jurement/
souuerain Sacrificateur/ qui est assis a la dextre du siege de la maieste es cieulx/	souverain Sacrificateur/ qui est assis a la dextre du siege de la majeste es cieulx/
lhomme. Sil estoit sur la terre il ne seroit point Sacrificateur. Christ souuerain	l’homme. S’il estoit sur la terre il ne seroit point Sacrificateur. Christ souverain
Sacrificateur des biens aduenir/ est uenu en presence par ung plus grand ⁊ plus	Sacrificateur des biens advenir/ est venu en presence par ung plus grand et plus
parfaict tabernacle: non point de la main/cest adire/ non point de ceste creation: et	parfaict tabernacle: non point de la main/cest a dire/ non point de ceste creation: et
foys es sainctuaires/ ⁊ a trouue redemption eternelle. Car si le sang des boucz/ ⁊	foys es sainctuaires/ et a trouve redemption eternelle. Car si le sang des boucz/ et
toreaulx/ ⁊ la cendre de la genisse esparse sainctifie les souillez pour la purificatiõ	toreaulx/ et la cendre de la genisse esparse sainctifie les souillez pour la purification
Dieu soymesmes sans macule/ nettoyera nostre conscience des oeuures mortes/	Dieu soymesmes sans macule/ nettoyera nostre conscience des oeuvres mortes/
que moyennant la mort/ ceulx qui sont appellez/ receoyuent la promesse de Leter¬	que moyennant la mort/ ceulx qui sont appellez/ receoyvent la promesse de L’eter¬
nel heritage en la redemption des transgressions lesquelles estoyent soubz le pre¬	nel heritage en la redemption des transgressions lesquelles estoyent soubz le pre¬
stament est conferme en ceulx qui sont mortz/ aultremẽt ne uault riens encores/	stament est conferme en ceulx qui sont mortz/ aultrement ne vault riens encores/
este desdie sans sang: car apres que le commandement de la loy fut leu par Moy¬	este desdie sans sang: car apres que le commandement de la loy fut leu par Moy¬
se a tout le peuple/ il print le sang des ueaulx ⁊ boucz/ auec de leau ⁊ de la laine	se a tout le peuple/ il print le sang des veaulx et boucz/ avec de l’eau et de la laine
ment le tabernacle ⁊ tous les uaisseaux qui y feruoyent/ ⁊ presque toutes choses	ment le tabernacle et tous les vaisseaux qui y fervoyent/ et presque toutes choses
de remission. Il est doncques necessaire que les figures des choses celestes fussent	de remission. Il est doncques necessaire que les figures des choses celestes fussent
nettoyees par ces choses: mais les choses celestes par meilleurs sacrifices que	nettoyees par ces choses: mais les choses celestes par meilleurs sacrifices que
figures des urays: mais au ciel mesmes/ affin que maintenant il apparoisse pour	figures des vrays: mais au ciel mesmes/ affin que maintenant il apparoisse pour
en la maniere que le souuerain Sacrificateur es sainctuaires tous les ans en au¬	en la maniere que le souverain Sacrificateur es sainctuaires tous les ans en au¬
tre sang que le sien/ aultrement il luy eut fallu souuentesfoys souffrir despuis le	tre sang que le sien/ aultrement il luy eut fallu souventesfoys souffrir despuis le
il est apparu une foys par son sacrifice/ pour la destruction de peche. Et ainsi quil	il est apparu une foys par son sacrifice/ pour la destruction de peche. Et ainsi qu’il
Christ a este offert une foys pour abolir les pechez de plusieurs. Christ resuscite	Christ a este offert une foys pour abolir les pechez de plusieurs. Christ resuscite
des mortz ne meurt iamais plus. Tout Sacrificateur assiste tous les iours/ ad¬	des mortz ne meurt jamais plus. Tout Sacrificateur assiste tous les jours/ ad¬
il est impossible que les pechez soyent ostez par le sang des toreaulx ⁊ des boucz.	il est impossible que les pechez soyent ostez par le sang des toreaulx et des boucz.
approchent aultrement ilz eussent cesse destre offers/ pource que les sacrifians	approchent aultrement ilz eussent cesse d’estre offers/ pour ce que les sacrifians
nettoyez une foys nauroyent plus aucun remors de peche: mais par iceulx est	nettoyez une foys n’auroyent plus aucun remors de peche: mais par iceulx est
que ie face ta uolunte/ il oste le premier: affin quil establisse le second/ par laquelle	que je face ta volunte/ il oste le premier: affin qu’il establisse le second/ par laquelle
Christ. Cestuy offrant ung sacriffice pour les pechez/ est assis eternellement	Christ. Cestuy offrant ung sacriffice pour les pechez/ est assis eternellement
a la dextre de Dieu/ du surplus attendant iusques a ce que ses ennemys soyent	a la dextre de Dieu/ du surplus attendant jusques a ce que ses ennemys soyent
les sainctifiez. Ie nauray plus souuenance doresnauant de leurs pechez ⁊ de leurs	les sainctifiez. Je n’auray plus souvenance doresnauant de leurs pechez et de leurs
Il ne nous est plus laisse sacrifice pour les pechez. Sachans que uous estes ra¬	Il ne nous est plus laisse sacrifice pour les pechez. Sachans que vous estes ra¬
chetez de uostre uaine conuersation de la tradition de uoz peres/ non point par cho	chetez de vostre vaine conversation de la tradition de voz peres/ non point par cho¬
est comme laigneau incõtamine ⁊ sans macule. Le sang de son filz Iesus Christ	est comme l’aigneau incontamine et sans macule. Le sang de son filz Jesus Christ
nous nettoye de tout peche. Iesus Christ qui est fidele tesmoing/ premier ne des	nous nettoye de tout peche. Jesus Christ qui est fidele tesmoing/ premier ne des
mortz/ ⁊ prince des roys de la terre/ lequel nous a ayme/ ⁊ nous a laue de noz pe¬	mortz/ et prince des roys de la terre/ lequel nous a ayme/ et nous a lave de noz pe¬
est chief de Leglise: ⁊ iceluy est le sauueur de son corps. Christ a ayme son Eglise: ⁊	est chief de L’eglise: et iceluy est le sauveur de son corps. Christ a ayme son Eglise: et
ment de leaue/ par la parolle de uie/ affin quil rendit a soy Leglise glorieuse nayãt	ment de l’eaue/ par la parolle de vie/ affin qu’il rendit a soy L’eglise glorieuse n’ayant
quelque tache ou ride / ou aucune telle chose: mais affin quelle soit saincte ⁊ sans	quelque tache ou ride / ou aucune telle chose: mais affin qu’elle soit saincte et sans
la maieste aux lieux haultz/ Iesus dit. Ie suis le pain de uie/ qui uiẽt a moy il nau	la majeste aux lieux haultz/ Jesus dit. Je suis le pain de vie/ qui vient a moy il n’au¬
⁊ croit en luy/ a la uie eternelle: ⁊ ie le resusciteray au dernier iour. Qui mãge ma	et croit en luy/ a la vie eternelle: et je le resusciteray au dernier jour. Qui mange ma
chair ⁊ boit mon sang/ il a la uie eternelle/ ⁊ ie le resusciteray au dernier iour. Qui	chair et boit mon sang/ il a la vie eternelle/ et je le resusciteray au dernier jour. Qui
les parolles lesquelles uous ay dictes/ sont esprit ⁊ uie. Si aucun uous dit/ icy est	les parolles lesquelles vous ay dictes/ sont esprit et vie. Si aucun vous dit/ icy est
tes/ ⁊ feront grandz signes ⁊ prodiges/ tellement q̃ les esleuz mesmes (sil se peult	tes/ et feront grandz signes et prodiges/ tellement que les esleuz mesmes (s’il se peult
faire) soyent induitz a erreur. Si donc ilz uous disent/ uoicy il est au desert/ ny sor	faire) soyent induitz a erreur. Si donc ilz vous disent/ voicy il est au desert/ n’y sor¬
si que lesclair sort de orient ⁊ apparoist iusques en occident/ ainsi sera laduenemẽt	si que l’esclair sort de orient et apparoist jusques en occident/ ainsi sera l’advenement
lauez ueu aller au ciel. Entretant que les temps de repos de la presence du Sei¬	l’avez veu aller au ciel. Entretant que les temps de repos de la presence du Sei¬
gneur Dieu uiendront/ ⁊ quil enuoyera Iesus Christ/ qui parauant uous a este	gneur Dieu viendront/ et qu’il envoyera Jesus Christ/ qui paravant vous a este
toutes les choses que le Seigneur Dieu a parle par la bouche de ses sainctz pro¬	toutes les choses que le Seigneur Dieu a parle par la bouche de ses sainctz pro¬
fut receu au ciel/ ⁊ se sied a la dextre de Dieu. Si uoꝰ estes resuscitez auec Christ:	fut receu au ciel/ et se sied a la dextre de Dieu. Si vous estes resuscitez avec Christ:
cerchez les choses qui sont denhault/ ou Christ est seãd a la dextre de Dieu/ pen¬	cerchez les choses qui sont d’en hault/ ou Christ est seand a la dextre de Dieu/ pen¬
maintenant est/ quand les urays adorateurs adoreront le Pere en Esprit ⁊ uerite:	maintenant est/ quand les vrays adorateurs adoreront le Pere en Esprit et verite:
ladorent en esprit ⁊ uerite.	l’adorent en esprit et verite.
¶ Par cecy ung chascun uray Chrestien peult entendre la pure saincte ⁊ honno¬	¶ Par cecy ung chascun vray Chrestien peult entendre la pure saincte et honno¬
Iesus lequel il fault croire estre plus parfaict puissant/ bon/ ⁊ sage que tous/ telle¬	Jesus lequel il fault croire estre plus parfaict puissant/ bon/ et sage que tous/ telle¬
ne: ⁊ celuy qui presume aultremẽt ordõner ⁊ faire que Iesus na cõmãde/ il est uray	ne: et celuy qui presume aultrement ordonner et faire que Jesus n’a commande/ il est vray
Antechrist/ ⁊ cõme tel sentira ⁊ portera amer iugemẽt de dãnation eternelle. Il ne	Antechrist/ et comme tel sentira et portera amer jugement de damnation eternelle. Il ne
moingz/ qui ont escript la pure uerite cõme ilz saccordẽt a ung mesmes sens/ com¬	moingz/ qui ont escript la pure verite comme ilz s’accordent a ung mesmes sens/ com¬
ptures cõme font les enchãteurs de leurs enchãtemẽs/ sy une syllabe estoit laissee/	ptures comme font les enchanteurs de leurs enchantemens/ sy une syllabe estoit laissee/
ou ung signe de croix/ qui ne fust faict/ que tout ne uauldroit riẽs. Le tout est que	ou ung signe de croix/ qui ne fust faict/ que tout ne vauldroit riens. Le tout est que
Iesus a porte pour nous/ nous rachetãt ⁊ purgeant par son sang precieux: ⁊ aussi	Jesus a porte pour nous/ nous rachetant et purgeant par son sang precieux: et aussi
nous a aymez/ soyõs tous uns. Et ne fault uenir indignemẽt a ceste saincte table/	nous a aymez/ soyons tous uns. Et ne fault venir indignement a ceste saincte table/
Iesus la cene ordõne/ en memoire de la mort ⁊ passion.	Jesus la cene ordonne/ en memoire de la mort et passion.
sont incorporez ⁊ inserez a Ie¬	sont incorporez et inserez a Je¬
doibt regarder sil a uraye foy:	doibt regarder s’il a vraye foy:
car aultre ne le peult scauoir q̃	car aultre ne le peult scavoir que
prouuer soymesmes/ non pas	prouver soymesmes/ non pas
soit cerche quen son coeur. Il ne	soit cerche qu’en son coeur. Il ne
fault que personne soit mespri¬	fault que personne soit mespri¬
ment la table de nostre Seigñr	ment la table de nostre Seigneur
dune mesme sorte en ung mes¬	d’une mesme sorte en ung mes¬
me temps/ cest quon attende	me temps/ c’est qu’on attende
mesme pain/ ⁊ dung mesme ca¬	mesme pain/ et d’ung mesme ca¬
pechez est par la foy quon ha a	pechez est par la foy qu’on ha a
Iesus: au nom duquel lon de¬	Jesus: au nom duquel l’on de¬
sion des pechez pardonnant a tous: ⁊ ainsi nous est promis/ ⁊ non aultrement.	sion des pechez pardonnant a tous: et ainsi nous est promis/ et non aultrement.
Pere pour noz pechez/ ⁊ aultre ny a. Iesus a faict ung seul sacrifice parfaict une	Pere pour noz pechez/ et aultre n’y a. Jesus a faict ung seul sacrifice parfaict une
foys/ lequel sacrifice est tout aultre que les sacrifices de la foy qui estoyent tous	foys/ lequel sacrifice est tout aultre que les sacrifices de la foy qui estoyent tous
il est tousiours uiuant/ et nest empesche par la mort dexercer son office/ comme	il est tousjours vivant/ et n’est empesche par la mort d’exercer son office/ comme
gatoire ne fault imaginer que le seul sang de Iesus/ qui est seul chief de Leglise	gatoire ne fault imaginer que le seul sang de Jesus/ qui est seul chief de L’eglise
son espouse/ laquelle il nourrist de soymesmes: car il est le pain de uie/ ⁊ sa chair est	son espouse/ laquelle il nourrist de soymesmes: car il est le pain de vie/ et sa chair est
qui parfaictemẽt croyent que Iesus est mort pour noz pechez/ ⁊ resuscite pour no¬	qui parfaictement croyent que Jesus est mort pour noz pechez/ et resuscite pour no¬
portent les parolles de uie qui sont Esprit. Pourquoy on ne regarde ⁊ on ne se ar¬	portent les parolles de vie qui sont Esprit. Pourquoy on ne regarde et on ne se ar¬
reste au pain ne au uin/ cerchant ca bas Iesus: mais toute la pensee du fidele tyre	reste au pain ne au vin/ cerchant ca bas Jesus: mais toute la pensee du fidele tyre
a chose uisible/ ne a aucune ceremonie ne a rien/ fors que au seul Dieu ladorant	a chose visible/ ne a aucune ceremonie ne a rien/ fors que au seul Dieu l’adorant
a faicte: mais en luy rendant graces on aye continuelle souuenance de la mort et	a faicte: mais en luy rendant graces on aye continuelle souvenance de la mort et
passion que Iesus son filz a porte pour nous/ tachant de uiuement exprimer Ie¬	passion que Jesus son filz a porte pour nous/ tachant de vivement exprimer Je¬
te/ aydant ⁊ secourant a son frere/ tout ainsi quon uouldroit quon nous aydast/ suy	te/ aydant et secourant a son frere/ tout ainsi qu’on vouldroit qu’on nous aydast/ suy¬
a ayme/ comme il commande requerant layde ⁊ le S. Esprit du Pere/ par lequel	a ayme/ comme il commande requerant l’ayde et le Sainct Esprit du Pere/ par lequel
soit parfaict en nous son bon plaisir.	soit parfaict en nous son bon plaisir.
Sed fedus dissipat iste.	Sed fedus dissipat iste.
A messe est controuuee	A messe est controuvee
au lieu de la cene de no¬	au lieu de la cene de no¬
appert en ce quilz appellent con¬	appert en ce qu’ilz appellent con¬
ment aucunes parolles q̃ nostre	ment aucunes parolles que nostre
Seigneur dit faisant la cene: cõ¬	Seigneur dit faisant la cene: com¬
fault q̃ la messe soit dicte en ung	fault que la messe soit dicte en ung
se consacree/ combien que Eglise	se consacree/ combien que Eglise
soit congregation ⁊ assemblee de	soit congregation et assemblee de
la messe sur ung autel consacre/	la messe sur ung autel consacre/
faire chãter messes en leurs mai	faire chanter messes en leurs mai¬
sons. Et en cecy se faict le pape	sons. Et en cecy se faict le pape
sa cene en ung cenacle/ en une sale/ sur une table/ ⁊ aussi que les sainctz Apostres/	sa cene en ung cenacle/ en une sale/ sur une table/ et aussi que les sainctz Apostres/
du a toꝰ laiz destre au lieu ou sont les sacrificateurs/ cest adire ceulx qͥ exercẽt loffi	du a tous laiz d’estre au lieu ou sont les sacrificateurs/ c’est a dire ceulx qui exercent l’offi¬
ce sacerdotal/ ⁊ les clercz/ leq̃l lieu on appelle presbytere/ ⁊ ce au temps de la messe	ce sacerdotal/ et les clercz/ lequel lieu on appelle presbytere/ et ce au temps de la messe
estre separez des laiz. Et ce au cõtraires de Iesus qui est assis au milieu de ses di¬	estre separez des laiz. Et ce au contraires de Jesus qui est assis au milieu de ses di¬
le prestre/ leuesque/ ⁊ le pape/ lesquelz ont uestemẽs diuers ⁊ diuerses ceremonies/	le prestre/ l’evesque/ et le pape/ lesquelz ont vestemens divers et diverses ceremonies/
lesquelles seroit chose fort facheuse a reciter/ ceulx qui ont tant de loysir regardãt	lesquelles seroit chose fort facheuse a reciter/ ceulx qui ont tant de loysir regardant
luy quon appelle Pastorale. Et a bon droict sera lon estonne des singeries que ces	luy qu’on appelle Pastorale. Et a bon droict sera l’on estonne des singeries que ces
uestemens/ nappes/ seruiettes/ mouchoirs corporaulx/ uaisseaux de boys/ de pier¬	vestemens/ nappes/ serviettes/ mouchoirs corporaulx/ vaisseaux de boys/ de pier¬
res/ couuertures/ lesquelles choses le Pape commande/ quand sont presque con¬	res/ couvertures/ lesquelles choses le Pape commande/ quand sont presque con¬
aymant mieulx quon les destruise sans proffit/ que si lon les faisoit seruir a quel¬	aymant mieulx qu’on les destruise sans proffit/ que si l’on les faisoit servir a quel¬
le pain apres la consecration/ mais quand le peuple uiẽt pour le receuoir/ le prestre	le pain apres la consecration/ mais quand le peuple vient pour le recevoir/ le prestre
le met dedans la bouche dung chascun/ le calice est a tous deffendu/ fors a iceluy qͥ	le met dedans la bouche d’ung chascun/ le calice est a tous deffendu/ fors a iceluy qui
ou il fut ordonne/ q̃ aux cõmunians on ne dõnast le sacremẽt fors q̃ en une espece/	ou il fut ordonne/ que aux communians on ne donnast le sacrement fors que en une espece/
sur ce Ioãnes hus/ ⁊ Hierosme de pragit furent bruslez/ pourtant qͥlz ne uouloyẽt	sur ce Joannes hus/ et Hierosme de pragit furent bruslez/ pourtant qu’ilz ne vouloyent
cõsentir aux cardinaulx/ euesques/ ⁊ abbez/ ⁊ ne se uolurent desdire ne reuocquer	consentir aux cardinaulx/ evesques/ et abbez/ et ne se volurent desdire ne revocquer
Et le Pape la messe controuue.	Et le Pape la messe controuve.
mande que tous en boyuent/ disant: beuuez de cestuy tous: ⁊ tous en beurent/ com¬	mande que tous en boyvent/ disant: beuvez de cestuy tous: et tous en beurent/ com¬
me recite S. Marc. Et nostre Seigneur ne dit point bayez ou ouurez la bouche/	me recite Sainct Marc. Et nostre Seigneur ne dit point bayez ou ouvrez la bouche/
gneu/ que celuy concile est hereticque ⁊ reprouue de Dieu/ irritant ⁊ mettãt a neãt	gneu/ que celuy concile est hereticque et reprouve de Dieu/ irritant et mettant a neant
seulement le commandement de Dieu: mais leurs malheureux decretz/ qui com	seulement le commandement de Dieu: mais leurs malheureux decretz/ qui com¬
mãde quon prẽne le pain/ ⁊ le calice entieremẽt/ ou quon se abstiẽne de tous deux.	mande qu’on prenne le pain/ et le calice entierement/ ou qu’on se abstienne de tous deux.
laction ⁊ le demainement de la cause ⁊ du plait/ loratoire est le pretoire/ laudiẽce le	l’action et le demainement de la cause et du plait/ l’oratoire est le pretoire/ l’audience le
moingz: le sacrificateur/ cest adire celuy qui faict loffice sacerdotal/ est laduocat ⁊	moingz: le sacrificateur/ c’est a dire celuy qui faict l’office sacerdotal/ est l’advocat et
le deffenseur/ il est Moyse/ qui faict les allegatiõs pour la cause du peuple/ par son	le deffenseur/ il est Moyse/ qui faict les allegations pour la cause du peuple/ par son
solue/ lire du iuge appaisee ⁊ par misericorde la coulpe est remise. Cõferez ces pa¬	solue/ l’ire du juge appaisee et par misericorde la coulpe est remise. Conferez ces pa¬
sa memoire/ ⁊ nottez les motz que Iesus a dit des faulx Christz ⁊ uerrez estre ac¬	sa memoire/ et nottez les motz que Jesus a dit des faulx Christz et verrez estre ac¬
complis es prestres du Pape/ qͥ biẽ sappellent sacerdotes/ cest adire sacrificateurs/	complis es prestres du Pape/ qui bien s’appellent sacerdotes/ c’est a dire sacrificateurs/
estre/ ainst que S. Paul en a escript: Loffice du uray Christ cest estre aduocat/ in¬	estre/ ainst que Sainct Paul en a escript: L’office du vray Christ c’est estre advocat/ in¬
Seigneur Iesus/ qui a prins nostre cause ⁊ est nostre patrocinateur/ nostre pa¬	Seigneur Jesus/ qui a prins nostre cause et est nostre patrocinateur/ nostre pa¬
tron: nous sommes en sa sauue garde/ il a destruict toute la puissance diabolicque/	tron: nous sommes en sa sauvegarde/ il a destruict toute la puissance diabolicque/
par lequel grace ⁊ uerite nous est donnee. Et le chanteur de messe ueult auoir tout	par lequel grace et verite nous est donnee. Et le chanteur de messe veult avoir tout
dormir deux foys/ apant la chemise sur la robbe/ tant sont ingratz les papistes	dormir deux foys/ apant la chemise sur la robbe/ tant sont ingratz les papistes
quilz nont honte de dire ⁊ penser/ que le prestre face ce que Iesus seul a peu faire/ ⁊	qu’ilz n’ont honte de dire et penser/ que le prestre face ce que Jesus seul a peu faire/ et
soy mettre au lieu du filz de Dieu/ ⁊ soy appeller mediateurs de Dieu ⁊ des hom¬	soy mettre au lieu du filz de Dieu/ et soy appeller mediateurs de Dieu et des hom¬
la messe/ ⁊ comme la messe aussi donne a entendre/ laquelle nest que pour faire di¬	la messe/ et comme la messe aussi donne a entendre/ laquelle n’est que pour faire di¬
uision ⁊ separation comme si nous nestiõs toꝰ freres rachetez dung mesme pris/	vision et separation comme si nous n’estions tous freres rachetez d’ung mesme pris/
soyent pres ⁊ au dessus/ ⁊ les aultres comme indignes ⁊ reiectez soyent loing/ ne	soyent pres et au dessus/ et les aultres comme indignes et rejectez soyent loing/ ne
⁊ diuision. Les prestres ne prennent ilz continuellement le pain ⁊ le calice a part	et division. Les prestres ne prennent ilz continuellement le pain et le calice a part
⁊ seulz/ faisans contre lordonnance de nostre Seigñr? pource ilz ne peuuent man	et seulz/ faisans contre l’ordonnance de nostre Seigneur? pour ce ilz ne peuvent man¬
ble/ silz ne la sont/ ⁊ si ce nest la cene de nostre Seigneur/ de qui sera elle? La proba¬	ble/ s’ilz ne la sont/ et si ce n’est la cene de nostre Seigneur/ de qui sera elle? La proba¬
rolle ⁊ de faict/ ⁊ les dire a son propre cure a tout le moins une foys lan/ ⁊ accom¬	rolle et de faict/ et les dire a son propre cure a tout le moins une foys l’an/ et accom¬
plir sa penitence: ⁊ apres la confession ⁊ satisfaction puisent uenir aux sacremẽs	plir sa penitence: et apres la confession et satisfaction puisent venir aux sacremens
mention: ne aussi de asseurer les consciences destre deliurees par soy/ laquelle el¬	mention: ne aussi de asseurer les consciences d’estre delivrees par soy/ laquelle el¬
chief de toute abusion.	chief de toute abusion.
Et quen pardonnant lon aye pardon/ de ce ne faict on aucune mẽtion/ fors que en	Et qu’en pardonnant l’on aye pardon/ de ce ne faict on aucune mention/ fors que en
pardons/ ⁊ quõ prent des indulgences/ tant de iubilez ⁊ plenieres remissions de	pardons/ et qu’on prent des indulgences/ tant de jubilez et plenieres remissions de
combien que sainct Pierre les die mauldictz/ disant a celuy qui offroit argẽt pour	combien que sainct Pierre les die mauldictz/ disant a celuy qui offroit argent pour
auoir le don de Dieu. Ton argent soit auec toy en perdition/ qui as pense quon	avoir le don de Dieu. Ton argent soit avec toy en perdition/ qui as pense qu’on
de uerite/ ⁊ menez hors du sainct Euangile pour soy fier aux choses uaines ⁊ pe¬	de verite/ et menez hors du sainct Evangile pour soy fier aux choses vaines et pe¬
tout au lieu de Iesus/ ⁊ faire Iesus uain et superflu/ ⁊ tout ce quil a faict ilz attri¬	tout au lieu de Jesus/ et faire Jesus vain et superflu/ et tout ce qu’il a faict ilz attri¬
buent au prestre tout ce que appartient seulement a Iesus: en quoy lon faict ung	buent au prestre tout ce que appartient seulement a Jesus: en quoy l’on faict ung
de limmolation (cest au canon) en laquelle Christ de rechief meurt/ son corps par	de l’immolation (c’est au canon) en laquelle Christ de rechief meurt/ son corps par
sont presens/ ⁊ les choses souueraines ⁊ tresbasses sont associees ⁊ conioinctes/ ⁊	sont presens/ et les choses souveraines et tres basses sont associees et conjoinctes/ et
est faict une chose des choses uisibles ⁊ inuisibles. En mesmes temps il est prins	est faict une chose des choses visibles et invisibles. En mesmes temps il est prins
les ieulx du Sacrificateur/ il est ueu en lautel/ et apres plusieurs choses dit/ que	les jeulx du Sacrificateur/ il est veu en l’autel/ et apres plusieurs choses dit/ que
nous auons remission des pechez. Gratian dit que ces parolles sont de Gregoi¬	nous avons remission des pechez. Gratian dit que ces parolles sont de Gregoi¬
re en lhomelie de pasques. Ie uouldroye prier ces gens/ quilz nous dient quel	re en l’homelie de pasques. Je vouldroye prier ces gens/ qu’ilz nous dient quel
⁊ quil soit tous les iours sacrifie ⁊ immole/ qui uault autant a dire. Car la chose	et qu’il soit tous les jours sacrifie et immole/ qui vault autant a dire. Car la chose
re de son filz Isaac/ lequel il uouloit sacrifier tirant le couteau pour le frapper. Et	re de son filz Isaac/ lequel il vouloit sacrifier tirant le couteau pour le frapper. Et
Iephthe qui sacrifia sa fille il la tua/ ⁊ aultrement ne trouuerez sacrifice auoir este	Jephthe qui sacrifia sa fille il la tua/ et aultrement ne trouverez sacrifice avoir este
que cecy est ung sacrifice de louenge/ ⁊ que ainsi de rechief Iesus est offert ⁊ meurt.	que cecy est ung sacrifice de louenge/ et que ainsi de rechief Jesus est offert et meurt.
car Iesus na institue sa cene quen memoire de soy/ ⁊ aultremẽt ne parle Lescriptu¬	car Jesus n’a institue sa cene qu’en memoire de soy/ et aultrement ne parle L’escriptu¬
re. Il nest commãde de offrir/ ne de sacrifier/ ne de faire temple sacre/ ne autel/ telz	re. Il n’est commande de offrir/ ne de sacrifier/ ne de faire temple sacre/ ne autel/ telz
la mort du seigneur iusques a ce quil uiengne. Quant est de louuerture du ciel a	la mort du seigneur jusques a ce qu’il viengne. Quant est de l’ouverture du ciel a
bominations que commettent les prestres en leurs messes/ que le ciel est tout clotz	bominations que commettent les prestres en leurs messes/ que le ciel est tout clotz
⁊ ferme/ comme monstrent les tresgrosses tenebres/ qui ont remply tout le monde	et ferme/ comme monstrent les tres grosses tenebres/ qui ont remply tout le monde
il a este par le Pape ⁊ les siens. Des Anges qui sont ainsi presens en telles baul¬	il a este par le Pape et les siens. Des Anges qui sont ainsi presens en telles baul¬
peuuẽt estre par tout/ silz sont en aucun temps en ung lieu/ en ce mesme ilz ne peu¬	peuvent estre partout/ s’ilz sont en aucun temps en ung lieu/ en ce mesme ilz ne peu¬
uẽt estre en ung aultre. Si on faisoit la cene comme nostre Seigneur la comman¬	vent estre en ung aultre. Si on faisoit la cene comme nostre Seigneur la comman¬
semble/ il y auroit quelque apparence. Maintenant ou chascun prestre dit sa messe	semble/ il y auroit quelque apparence. Maintenant ou chascun prestre dit sa messe
Et le pape la messe controuue	Et le pape la messe controuve
droict ung personnage fasche de regarder tant desleuations que les prestres chan	droict ung personnage fasche de regarder tant d’eslevations que les prestres chan¬
uoyoit sortir ⁊ estre demenez des mains des prestres/ comme de counilz en une ga¬	voyoit sortir et estre demenez des mains des prestres/ comme de connilz en une ga¬
gnifier plus la dignite des prestres/ mettent en la messe uenir toute la court cele¬	gnifier plus la dignite des prestres/ mettent en la messe venir toute la court cele¬
stielle/ que Dieu ⁊ tous ses Anges descendent du ciel auec la uierge Marie ⁊ tous	stielle/ que Dieu et tous ses Anges descendent du ciel avec la vierge Marie et tous
a la uoix du putier prestre. Mais pour uray il y a plus de raison que les diables	a la voix du putier prestre. Mais pour vray il y a plus de raison que les diables
stituee/ ⁊ la saincte Cene de nostre Seigneur abrogee ⁊ du tout ostee. Pourquoy	stituee/ et la saincte Cene de nostre Seigneur abrogee et du tout ostee. Pourquoy
tant de croix sont faictes (cõme ilz disent) affin que la malignite diabolicque soit	tant de croix sont faictes (comme ilz disent) affin que la malignite diabolicque soit
tant Danges/ ⁊ Dieu y est si grãdement/ ⁊ la chose est si saincte (comme ilz disent)	tant D’anges/ et Dieu y est si grandement/ et la chose est si saincte (comme ilz disent)
saincte table de nostre Seigneur/ il ne fault point de croix/ ne aussi au sainct Ba¬	saincte table de nostre Seigneur/ il ne fault point de croix/ ne aussi au sainct Ba¬
ptesme: combien que les prestres en leurs fassons de faire/ ilz adiurẽt tant de foys	ptesme: combien que les prestres en leurs fassons de faire/ ilz adjurent tant de foys
Dieu innocente/ comme sont les enfans/ lesquelz Iesus a prins entre ses bras/	Dieu innocente/ comme sont les enfans/ lesquelz Jesus a prins entre ses bras/
fault ainsi entendre que nostre salut soit en ce que faict le prestre en la messe/ en son	fault ainsi entendre que nostre salut soit en ce que faict le prestre en la messe/ en son
sacrifice imaginatif/ ⁊ quil cuyde faire: mais comme la pure parolle de Dieu por¬	sacrifice imaginatif/ et qu’il cuyde faire: mais comme la pure parolle de Dieu por¬
crifice nous a consommez. Les papaulx qui suyuent ⁊ tiennẽt la doctrine du Pa¬	crifice nous a consommez. Les papaulx qui suyvent et tiennent la doctrine du Pa¬
a ceulx de Moyse/ mais beaucoup moindre: car iamais si prophanemẽt les sacri¬	a ceulx de Moyse/ mais beaucoup moindre: car jamais si prophanement les sacri¬
fices de Moyse ne furent faictz/ comme est faicte la messe/ laquelle faulcemẽt ilz	fices de Moyse ne furent faictz/ comme est faicte la messe/ laquelle faulcement ilz
maniere ⁊ la fin: ⁊ toutes les circonstances. Quelle beste y a sur la terre/ quon ne	maniere et la fin: et toutes les circonstances. Quelle beste y a sur la terre/ qu’on ne
pour auoir en demãdant/ ou pour perdre/ ⁊ quil soit oste ce quon demãde estre chas¬	pour avoir en demandant/ ou pour perdre/ et qu’il soit oste ce qu’on demande estre chas¬
se? de tout on faict des messes. Or il est escript que si les sacrifices de Moyse eus¬	se? de tout on faict des messes. Or il est escript que si les sacrifices de Moyse eus¬
Sacrifice de Iesus/ qui plainemẽt a efface les pechez/ a este faict une foys/ ⁊ nest	Sacrifice de Jesus/ qui plainement a efface les pechez/ a este faict une foys/ et n’est
cesseur: car il peult sauuer eternellement tous ceulx qui uiennent a luy estant	cesseur: car il peult sauver eternellement tous ceulx qui viennent a luy estant
tousiours uiuant/ en quoy le Pape ⁊ tous les siens luy font tresgrosse iniure luy	tousjours vivant/ en quoy le Pape et tous les siens luy font tres grosse injure luy
parolles contiennent: le Pape tient le lieu/ non de pur homme/ mais du uray	parolles contiennent: le Pape tient le lieu/ non de pur homme/ mais du vray
Pierre ilz ueulent que tous les Papes soyent successeurs/ et ainsi plusieurs sont	Pierre ilz veulent que tous les Papes soyent successeurs/ et ainsi plusieurs sont
ordonnez a cause de leur mort ⁊ deces / ainsi quil est aduenu a Aaron et a ses suc¬	ordonnez a cause de leur mort et deces / ainsi qu’il est aduenu a Aaron et a ses suc¬
tal eternel/ qui est grosse blaspheme cõtre la parolle de Dieu. Le Pape rẽuersant	tal eternel/ qui est grosse blaspheme contre la parolle de Dieu. Le Pape renversant
lato. ex¬	lato. ex¬
chief de toute abusion.	chief de toute abusion.
ctifiez ⁊ purifiez/ ce que doibuent faire tous les Sacrificateurs. Car si la cẽdre de	ctifiez et purifiez/ ce que doibvent faire tous les Sacrificateurs. Car si la cendre de
see du sel ⁊ sacree par prieres diuines/ sanctifie ⁊ netoye le peuple. Et si le sel asper¬	see du sel et sacree par prieres divines/ sanctifie et netoye le peuple. Et si le sel asper¬
se par Helisee le prophete a guery la sterilite de leaue/ par plus forte raison le sel sa¬	se par Helisee le prophete a guery la sterilite de l’eaue/ par plus forte raison le sel sa¬
les souillez/ multiplie les biens/ ⁊ chasse les espies ⁊ aguetz du diable/ ⁊ garde les	les souillez/ multiplie les biens/ et chasse les espies et aguetz du diable/ et garde les
si blaspheme ⁊ destruict la parolle de Dieu/ ⁊ ainsi quasi par tout il a faict. En la	si blaspheme et destruict la parolle de Dieu/ et ainsi quasi par tout il a faict. En la
premiere Eglise tous les iours lon faisoit la cene/ laquelle estoit prinse de tous/	premiere Eglise tous les jours l’on faisoit la cene/ laquelle estoit prinse de tous/
une: ⁊ le dimenche est donne le pain benict/ au lieu de la cene/ ainsi disent ilz. La	une: et le dimenche est donne le pain benict/ au lieu de la cene/ ainsi disent ilz. La
autant comme les papes ou peu/ renuoyans a Dieu/ comme ilz disent/ ce qui leur	autant comme les papes ou peu/ renvoyans a Dieu/ comme ilz disent/ ce qui leur
a dõne. Car ilz disent/ offrir pour Leglise saincte catholicque/ en la premiere par¬	a donne. Car ilz disent/ offrir pour L’eglise saincte catholicque/ en la premiere par¬
mier memento/ ⁊ pour les assistens ⁊ presens/ qui sont ditz offrir auec celuy qui	mier memento/ et pour les assistens et presens/ qui sont ditz offrir avec celuy qui
en leur communicantes ilz font commemoration daultres que de Iesus/ au con¬	en leur communicantes ilz font commemoration d’aultres que de Jesus/ au con¬
traire de ce que Iesus a cõmande/ cest quon fist en sa commemoration. Les parolles	traire de ce que Jesus a commande/ c’est qu’on fist en sa commemoration. Les parolles
sur le uin secrettemẽt: ⁊ cest affin quelles ne soyent uilipendees ⁊ mesprisees/ et	sur le vin secrettement: et c’est affin qu’elles ne soyent vilipendees et mesprisees/ et
che Leuangile/ cest affin que Leuangile ⁊ eulx aussi ne fussent mesprisez/ en ce e¬	che L’evangile/ cest affin que L’evangile et eulx aussi ne fussent mesprisez/ en ce e¬
stans plꝰ sages que Dieu/ qui ueult quon crie sans cesser/ ⁊ que on annõce au peu¬	stans plus sages que Dieu/ qui veult qu’on crie sans cesser/ et que on annonce au peu¬
aussi Leuangile a toute creature/ ce que ont faict les Apostres: ⁊ quelque mespris	aussi L’evangile a toute creature/ ce que ont faict les Apostres: et quelque mespris
sus preschant en grosse diligence par tout. Lon faict adorer le pain ⁊ le calice en la	sus preschant en grosse diligence par tout. L’on faict adorer le pain et le calice en la
messe/ apres les parolles sacramentales (comme ilz disent) lesquelles si ne sont	messe/ apres les parolles sacramentales (comme ilz disent) lesquelles si ne sont
roit idolatre/ adorant pour Dieu/ ce qui nest point Dieu: car toutes les choses des¬	roit idolatre/ adorant pour Dieu/ ce qui n’est point Dieu: car toutes les choses des¬
soit prestre ⁊ que le charactere luy soit imprime/ pour muer le pain ⁊ en faire ung	soit prestre et que le charactere luy soit imprime/ pour muer le pain et en faire ung
Dieu: en quoy bien monstrent leur cas estre fonde sur neige ⁊ sur la sable: car se¬	Dieu: en quoy bien monstrent leur cas estre fonde sur neige et sur la sable: car se¬
en dangier destre idolatres ainsi que urayement ilz le sont/ comme contient la pa	en dangier d’estre idolatres ainsi que vrayement ilz le sont/ comme contient la pa¬
tion il ha: car aultre ne la scait que Dieu. Des parolles ilz ne scauent aussi/ ueu	tion il ha: car aultre ne la scait que Dieu. Des parolles ilz ne scavent aussi/ veu
quelles sont dictes que personne ne les oyt ⁊ entend. Et a riẽ ne sert/ ce q̃ de Quer	qu’elles sont dictes que personne ne les oyt et entend. Et a rien ne sert/ ce que de Quer¬
doibt dire en soy/ Seigneur si tu es la/ ⁊ q̃ le prestre aye faict son debuoir/ ie te ado¬	doibt dire en soy/ Seigneur si tu es la/ et que le prestre aye faict son debvoir/ je te ado¬
en plaine foy ⁊ certitude que ce que nous adorõs est le uray ⁊ seul Dieu/ ou aultre¬	en plaine foy et certitude que ce que nous adorons est le vray et seul Dieu/ ou aultre¬
Et le pape la messe controuue	Et le pape la messe controuve
te adore si tu es ceste pierre ⁊ si tu ueulx en icelle estre adore: aultremẽt ie ne te ado¬	te adore si tu es ceste pierre et si tu veulx en icelle estre adore: aultrement je ne te ado¬
pressement de soy incliner a chose faicte des mains des hommes. En tenant ⁊ cõ¬	pressement de soy incliner a chose faicte des mains des hommes. En tenant et con¬
fessant la doctrine du Pape que a la uoix du prestre le corps de Iesus descend du	fessant la doctrine du Pape que a la voix du prestre le corps de Jesus descend du
stantie au corps de Christ: ⁊ le sang aussi soubz les especes de uin/ q̃ aussi est trans¬	stantie au corps de Christ: et le sang aussi soubz les especes de vin/ que aussi est trans¬
sant/ lon renonce la foy ⁊ la creance q̃ tous Chrestiens tiennent ⁊ confessent estre	sant/ l’on renonce la foy et la creance que tous Chrestiens tiennent et confessent estre
uraye: ⁊ la repute lon faulse/ car tous croyõs q̃ nostre Seigneur Iesus est resusci¬	vraye: et la repute l’on faulse/ car tous croyons que nostre Seigneur Jesus est resusci¬
⁊ est assis a la dextre du Pere: ⁊ de la uiendra iuger les uifz ⁊ les mortz/ uenant	et est assis a la dextre du Pere: et de la viendra juger les vifz et les mortz/ venant
ne les passages quilz deffendent de croyre a ceulx qui disent icy est Christ ou la/ ⁊	ne les passages qu’ilz deffendent de croyre a ceulx qui disent icy est Christ ou la/ et
quilz monstrent quil fault cercher les choses qui sont la sus ou Iesus est assis a	qu’ilz monstrent qu’il fault cercher les choses qui sont la sus ou Jesus est assis a
escripture est cõtenu que les prestres ayent la puissance de faire descendre le corps	escripture est contenu que les prestres ayent la puissance de faire descendre le corps
sus/ ⁊ le uin en son sang pour lenclorre ⁊ enfermer dedans ung armaire ⁊ le porter	sus/ et le vin en son sang pour l’enclorre et enfermer dedans ung armaire et le porter
dedans une boyste? ilz ne scauroyent guerir ung pied de mouche/ combien que no¬	dedans une boyste? ilz ne scauroyent guerir ung pied de mouche/ combien que no¬
des/ ce que nous lisons clairement auoir este faict: mais que on puisse faire uenir	des/ ce que nous lisons clairement avoir este faict: mais que on puisse faire venir
doubter que Dieu eut plainement monstre par la saincte escripture quelle reuerẽ¬	doubter que Dieu eut plainement monstre par la saincte escripture quelle reveren¬
ce/ ⁊ quel honneur lon doibt faire au sacrement: ⁊ cõment il le fault adorer/ ueu que	ce/ et quel honneur l’on doibt faire au sacrement: et comment il le fault adorer/ veu que
le sorte leur fault ayder/ de la maniere de uiure tant en faictz comme en ditz/ affin	le sorte leur fault ayder/ de la maniere de vivre tant en faictz comme en ditz/ affin
rolle/ ⁊ mesmes monstrent cõme lon doibt uenir a la table: mais les seulz Papes	rolle/ et mesmes monstrent comme l’on doibt venir a la table: mais les seulz Papes
⁊ leurs adherens ont faict de gros cas/ comme il fault cracher apres auoir receu le	et leurs adherens ont faict de gros cas/ comme il fault cracher apres avoir receu le
que: beste/ sil tombe sur la terre ou sur drapeaulx/ ⁊ quelz draps il fault auoir/ com¬	que: beste/ s’il tombe sur la terre ou sur drapeaulx/ et quelz draps il fault avoir/ com¬
de consecratione/ ⁊ ce que les docteurs en escripuent au quatriesme des sentences.	de consecratione/ et ce que les docteurs en escripvent au quatriesme des sentences.
Tous les tours du prestre sont comptez/ tant ceulx qui sont du tout ou a la moy¬	Tous les tours du prestre sont comptez/ tant ceulx qui sont du tout ou a la moy¬
⁊ croix: ⁊ cõbien de pieces il doibt faire de son paoure Dieu/ laquelle il doibt met¬	et croix: et combien de pieces il doibt faire de son paovre Dieu/ laquelle il doibt met¬
sont fort changees/ comme lon peult ueoir au chapitre ou il est dit/ pourquoy lon	sont fort changees/ comme l’on peult veoir au chapitre ou il est dit/ pourquoy l’on
faict troys partz du corps de Christ/ qui dit. Le corps du Seigneur est de troys	faict troys partz du corps de Christ/ qui dit. Le corps du Seigneur est de troys
corps de Christ est resuscite: la partie mangee/ le cheminant encore sur la terre/ ⁊	corps de Christ est resuscite: la partie mangee/ le cheminant encore sur la terre/ et
car iusques a la fin du siecle les corps des sainctz serõt au sepulchre. Des aultres	car jusques a la fin du siecle les corps des sainctz seront au sepulchre. Des aultres
chief de toute abusion.	chief de toute abusion.
pres la consecration traicte/ rompu ⁊ brise des dentz des fideles/ comme ilz ont cõ¬	pres la consecration traicte/ rompu et brise des dentz des fideles/ comme ilz ont con¬
cest chose horrible de penser: car sil estoit comme ilz disent/ iamais ne fut person¬	c’est chose horrible de penser: car s’il estoit comme ilz disent/ jamais ne fut person¬
ne si paoure ⁊ mauldicte que ce paoure Dieu/ a qui tous les iours ilz font tant de	ne si paovre et mauldicte que ce paovre Dieu/ a qui tous les jours ilz font tant de
ung peu gaste ou pourry ou mange des uers/ toutes ses blasphemes ⁊ mocqueries	ung peu gaste ou pourry ou mange des vers/ toutes ses blasphemes et mocqueries
la chair de Christ est tous les iours immolee/ sacrifiee/ pour la uie du monde/ que	la chair de Christ est tous les jours immolee/ sacrifiee/ pour la vie du monde/ que
repugne tout a la parolle de nostre Seigneur/ qui dit auoir este immole une foys.	repugne tout a la parolle de nostre Seigneur/ qui dit avoir este immole une foys.
grandz kyrie eleison: aux introites/ oraisons/ epistres/ responds/ es chantementz	grandz kyrie eleison: aux introites/ oraisons/ epistres/ responds/ es chantementz
nãce de Dieu/ ⁊ tout en aultre langaige que Dieu na cõmande/ la ou il ny a point	nance de Dieu/ et tout en aultre langaige que Dieu n’a commande/ la ou il n’y a point
de fruict ne dedification. Parquoy tous Chrestiens ⁊ fideles pour lamour dice¬	de fruict ne d’edification. Parquoy tous Chrestiens et fideles pour l’amour d’ice¬
la pure ⁊ simple ordonnance du bon sauueur Iesus/ duquel ⁊ par lequel uous auez	la pure et simple ordonnance du bon sauveur Jesus/ duquel et par lequel vous avez
pe/ duquel ⁊ par lequel iamais nest uenu que mal/ prenez ⁊ tenez ce qui est de Dieu/	pe/ duquel et par lequel jamais n’est venu que mal/ prenez et tenez ce qui est de Dieu/
⁊ tout certain: laissez ce qui est du pape ⁊ tout incertain: ⁊ ainsi suyuãtz Iesus uraye	et tout certain: laissez ce qui est du pape et tout incertain: et ainsi suyvantz Jesus vraye
rez pasture ⁊ repos a uoz ames.	rez pasture et repos a voz ames.
Ascendit Christus.	Ascendit Christus.
¶ Sentez certes en	¶ Sentez certes en
Iesus Christ/ lequel	Jesus Christ/ lequel
estoit en la forme de	estoit en la forme de
Dieu/ il na point re¬	Dieu/ il n’a point re¬
gal a Dieu: mais il	gal a Dieu: mais il
mes/ prenant la for¬	mes/ prenant la for¬
me du seruiteur/ faict	me du serviteur/ faict
hommes/ ⁊ trouue en	hommes/ et trouve en
Il sest humilie soy¬	Il s’est humilie soy¬
mesmes/ ⁊ a este faict	mesmes/ et a este faict
mort/ uoire a la mort	mort/ voire a la mort
quelle chose Dieu aussi la exalte ⁊ luy a dõne le nom lequel est sur tout nom/ affin	quelle chose Dieu aussi la exalte et luy a donne le nom lequel est sur tout nom/ affin
que au nom de Iesus tout genouil soit flechy de ceulx qui sont au ciel/ ⁊ qui sont	que au nom de Jesus tout genouil soit flechy de ceulx qui sont au ciel/ et qui sont
a la gloire de Dieu le pere. Philip.2. ¶ Quand uous estiez mortz en pechez/ ⁊	a la gloire de Dieu le pere. Philip.2. ¶ Quand vous estiez mortz en pechez/ et
les pechez/ effaceant lobligation qui estoit contre nous par les decretz/ laquelle	les pechez/ effaceant l’obligation qui estoit contre nous par les decretz/ laquelle
noꝰ estoit cõtraire/ ⁊ il la oste du millieu ⁊ la fiche a la croix/ ⁊ a despouille les prin	nous estoit contraire/ et il la oste du millieu et la fiche a la croix/ et a despouille les prin¬
de eulx par soymesmes. Colossen.2.	de eulx par soymesmes. Colossen.2.
tous qui pour nous a este faict moindre de tous. Et quãd il les benissoit/ il se par¬	tous qui pour nous a este faict moindre de tous. Et quand il les benissoit/ il se par¬
tit de eulx/ ⁊ fut esleue au ciel. Luce.24. Il a mõte en hault/ il a prins la capti¬	tit de eulx/ et fut esleve au ciel. Luce.24. Il a monte en hault/ il a prins la capti¬
ue uoyans iceulx/ ⁊ une nuee losta de leurs yeulx. Cestuy Iesus qui est receu	ve voyans iceulx/ et une nuee l’osta de leurs yeulx. Cestuy Jesus qui est receu
Son regne naura point de fin. Luce.1. Si aucun me sert/ si me ensuyue. Et la	Son regne n’aura point de fin. Luce.1. Si aucun me sert/ si me ensuyve. Et la
ou ie suis/ mon seruiteur y sera. Ioan.12.	ou je suis/ mon serviteur y sera. Joan.12.
Descendit ad infera	Descendit ad infera
¶ Qui se eslieue sera	¶ Qui se eslieve sera
humilie. Matth.23:	humilie. Matth.23:
ue sur tous il sera a¬	ve sur tous il sera a¬
tous. Tõ orgueil est	tous. Ton orgueil est
abbatu iusques aux	abbatu jusques aux
tu tombe lucifer sor¬	tu tombe lucifer sor¬
rue a terre qui auoys	rue a terre qui avoys
puissãce sur les gẽs?	puissance sur les gens?
sois en ton coeur: Ie	sois en ton coeur: Je
ie esleueray mon sie¬	je esleveray mon sie¬
ge sur les estoilles du	ge sur les estoilles du
teur des nuees/ ⁊ seray semblable au treshaultain. Maintenant es tu abbatu en	teur des nuees/ et seray semblable au tres haultain. Maintenant es tu abbatu en
te la grand Babylone/ ⁊ est faicte habitation des diables. Apocalip.18.	te la grand Babylone/ et est faicte habitation des diables. Apocalip.18.
¶ Et la beste fut prinse ⁊ auec elle le faulx prophete qui a faict les signes deuant	¶ Et la beste fut prinse et avec elle le faulx prophete qui a faict les signes devant
adore son image. Ces deux ont este enuoyes tout uifz dedans lestang du feu ar¬	adore son image. Ces deux ont este envoyes tout vifz dedans l’estang du feu ar¬
bouche de celuy qui estoit assis sur le cheual. Apoca.19. ¶ Et adoncques sera ma¬	bouche de celuy qui estoit assis sur le cheval. Apoca.19. ¶ Et adoncques sera ma¬
nifeste iceluy inique/ lequel nostre Seigneur Iesus occira de Lesperit de sa bou	nifeste iceluy inique/ lequel nostre Seigneur Jesus occira de L’esperit de sa bou¬
selon loperation de Sathan en toute puissance/ ⁊ signes/ ⁊ miracles de mensonge/	selon l’operation de Sathan en toute puissance/ et signes/ et miracles de mensonge/
la dilection de uerite: affin quilz fussent sauuez. Pource Dieu leur enuoyera ope¬	la dilection de verite: affin qu’ilz fussent sauvez. Pour ce Dieu leur envoyera ope¬
ration derreur pour croire a mensonges: affin que tous soyent iugez qui nõt point	ration d’erreur pour croire a mensonges: affin que tous soyent jugez qui n’ont point
¶ Aux lecteurs.	¶ Aux lecteurs.
ennemy son asne qͥ erre/ urayemẽt iceluy est fort inhumain/ cruel/ ⁊ hors de Dieu/ qͥ pẽse	ennemy son asne qui erre/ vrayement iceluy est fort inhumain/ cruel/ et hors de Dieu/ qui pense
nestre point tenu autãt a sauuer le corps de son amy/ ⁊ encore plus de tacher a retirer der¬	n’estre point tenu autant a sauver le corps de son amy/ et encore plus de tacher a retirer d’er¬
sang de nr̃e sauueur Iesꝰ/ laq̃lle chose pẽsant mes treschiers freres/ uoꝰ ay uoulu rẽdre	sang de notre sauveur Jesus/ laquelle chose pensant mes tres chiers freres/ vous ay voulu rendre
Iesus/ qͥ a porte toꝰ noz pechez/ ⁊ satisfaict poͬ nous/ payãt toutes les choses q̃ noꝰ deb¬	Jesus/ qui a porte tous noz pechez/ et satisfaict pour nous/ payant toutes les choses que nous deb¬
uiõs a cause de noz faultes/ par leq̃l seul ⁊ nõ aultre sõmes sauuez ⁊ iustifiez ⁊ sanctifiez/	vions a cause de noz faultes/ par lequel seul et non aultre sommes sauvez et justifiez et sanctifiez/
se sinõ que ayõs plaine foy ⁊ fiance en luy/ par laq̃lle noꝰ aurõs charite ⁊ dilection laq̃lle	se sinon que ayons plaine foy et fiance en luy/ par laquelle nous aurons charite et dilection laquelle
luy/ ⁊ quõ ne layme/ si lon le cõgnoit: car en ce est la uie eternelle/ ⁊ il est cõgneu quãd on	luy/ et qu’on ne l’ayme/ si l’on le congnoit: car en ce est la vie eternelle/ et il est congneu quand on
entẽd ⁊ cõgnoit ses grãdz ⁊ merueilleux benefices q̃ nr̃e bõ Seigñr ⁊ sauueur Iesus noꝰ	entend et congnoit ses grandz et merveilleux benefices que notre bon Seigneur et sauveur Jesus nous
donnãt a noꝰ: affin q̃ par luy soyõs enfans ⁊ heritiers de Dieu/ heritiers auec Iesus/ la	donnant a nous: affin que par luy soyons enfans et heritiers de Dieu/ heritiers avec Jesus/ la
de ne or ne argẽt: mais noꝰ dõne tout/ noꝰ remettãt le grãd fardeau de la loy/ par laq̃lle	de ne or ne argent: mais nous donne tout/ nous remettant le grand fardeau de la loy/ par laquelle
pesonne na peu estre iustifie ne sauue/ disirãt sur tout q̃ de bon coeur noꝰ receuiõs ses be¬	personne n’a peu estre justifie ne sauve/ disirant sur tout que de bon coeur nous recevions ses be¬
Christ nr̃e sauueur si tresdoulx ⁊ si tresamyable/ q̃ toꝰ qui lentẽdent sont tirez a laymer/	Christ notre sauveur si tres doulx et si tres amyable/ que tous qui l’entendent sont tirez a l’aymer/
est ce q̃ a tache son aduersaire lhõe de peche/ qͥ nous a seduict iusq̃s a p̃sent/ cõe icy appert/	est ce que a tache son adversaire l’home de peche/ qui nous a seduict jusques a present/ come icy appert/
nõ pas par choses cõtrouuees: mais par ses decretz ⁊ canõs qͥ sont par auãt alleguez/ qͥ de	non pas par choses controuvees: mais par ses decretz et canons qui sont par avant alleguez/ qui de
re auec eulx/ car lon ueoit biẽ q̃ toute son intẽtion est de cercher sa gloire/ la ou Iesus ne	re avec eulx/ car l’on veoit bien que toute son intention est de cercher sa gloire/ la ou Jesus ne
desrober le mõde. Ie uoꝰ prie pẽsez q̃l moyẽ eust peu trouuer le pape ⁊ les siẽs/ pour de¬	desrober le monde. Je vous prie pensez quel moyen eust peu trouver le pape et les siens/ pour de¬
cepuoir le mõde ⁊ le piller/ qͥl na trouue? Na il pas faict q̃ toꝰ princes/ roys/ empereurs/	cepvoir le monde et le piller/ qu’il n’a trouve? N’a il pas faict que tous princes/ roys/ empereurs/
est elle subiecte? qͥ est entre les Chrestiẽs/ duq̃l luy ⁊ les siẽs naye piece ou loupin/ poͬ entre	est elle subjecte? qui est entre les Chrestiens/ duquel luy et les siens n’aye piece ou loupin/ pour entre¬
tournez au bening sauueur Iesus/ ⁊ laissez ce cruel destructeur Antechrist. Prenez le saĩct	tournez au bening sauveur Jesus/ et laissez ce cruel destructeur Antechrist. Prenez le sainct
Euãgile de Iesus ⁊ sa saincte parolle. Laissez ce puãt pape ⁊ son escole. Car par luy tout	Evangile de Jesus et sa saincte parolle. Laissez ce puant pape et son escole. Car par luy tout
che destruicte. Angleterre seduicte. Espaigne mãgee, Italie gastee. Hũgrie captiue. Pol¬	che destruicte. Angleterre seduicte. Espaigne mangee, Italie gastee. Hungrie captive. Pol¬
mariages faulcemẽt rõpus. Moynes ordemẽt polluz. Nõnains au corps ⁊ lame ꝑdues/	mariages faulcement rompus. Moynes ordement polluz. Nonnains au corps et l’ame perdues/
⁊ a toute ordure uẽdues. Seigñrs abbatus. Ruffiẽs au dessus. Marchãs deuorez. Me¬	et a toute ordure vendues. Seigneurs abbatus. Ruffiens au dessus. Marchans devorez. Me¬
du pape reclus. Iustice des iustes ostee/ ⁊ aux iniq̃s dõnee. Le mal poͬ biẽ uẽdu. Et bien	du pape reclus. Justice des justes ostee/ et aux iniques donnee. Le mal pour bien vendu. Et bien
sus destruict. Et celuy de sathã introduict. O Iesus regarde labominatiõ/ de lord filz de	sus destruict. Et celuy de sathan introduict. O Jesus regarde l’abomination/ de l’ord filz de
perditiõ. Helas Seigñr cesse tõ ire. Et de ce mal si noꝰ deliure. Enuoye tõ puissãt Espe¬	perdition. Helas Seigneur cesse ton ire. Et de ce mal si nous delivre. Envoye ton puissant Espe¬
Ce nigromant (ne ueulx) meurtrier filz de putain. Cle.7.	Ce nigromant (ne veulx) meurtrier filz de putain. Cle.7.
¶ Pour les esleuz ces iours seront abregez. Matth.24.	¶ Pour les esleuz ces jours seront abregez. Matth.24.
¶ Par Lesperit de ses leures il occira le mescreant. Esaye.11.	¶ Par L’esperit de ses levres il occira le mescreant. Esaye.11.
le mocqueur deffauldra/ quand ceulx qui constraignoyent a faire iniquite	le mocqueur deffauldra/ quand ceulx qui constraignoyent a faire iniquite
¶ Hõmes corrompus dẽtendement/ reprouuez en la foy: mais ilz ne proffiteront	¶ Hommes corrompus d’entendement/ reprouvez en la foy: mais ilz ne proffiteront
plus, Car leur insipience sera manifestee a tous. 2.Timo.3.	plus, Car leur insipience sera manifestee a tous. 2.Timo.3.
¶ Cum priuilegio Apostolico.	¶ Cum privilegio Apostolico.
